TAAGACGAAATCTAATGACTGTTA -> AAGACGAAATCTAATGACTGTTAC
CCAGATCGCGCTTACTGACATTTT -> CAGATCGCGCTTACTGACATTTTG
GAGGGTATGGTTGCGCCACCCCCA -> AGGGTATGGTTGCGCCACCCCCAC
CCATTAGGGCGCAATTTATGAGCA -> CATTAGGGCGCAATTTATGAGCAC
GGATGGTCGGCACGAACTTAATAT -> GATGGTCGGCACGAACTTAATATG
GATAGCACCTGATCCTCTTCCATA -> ATAGCACCTGATCCTCTTCCATAA
CGGAACGTGAAGACCGCACGTTGA -> GGAACGTGAAGACCGCACGTTGAG
GGGGCGATTGACTTCCCGGCTAAC -> GGGCGATTGACTTCCCGGCTAACT
CTGGAGTAACACAAAACGCGTCAT -> TGGAGTAACACAAAACGCGTCATG
GAAGGACACTTTTGAACAACCTTG -> AAGGACACTTTTGAACAACCTTGT
TAGGGCGCAATTTATGAGCACGGG -> AGGGCGCAATTTATGAGCACGGGT
CTAGTTTGACCAGTCTCTCCCTGG -> TAGTTTGACCAGTCTCTCCCTGGA
TCTCGGAACGTGAAGACCGCACGT -> CTCGGAACGTGAAGACCGCACGTT
CCTCCTTTGTCTCGTCATTCCGAA -> CTCCTTTGTCTCGTCATTCCGAAG
CCGGCCGTCCTGGGACCGGAACCG -> CGGCCGTCCTGGGACCGGAACCGA
AGGCTCTTCTGCGCGGTACCAGTT -> GGCTCTTCTGCGCGGTACCAGTTT
TGAAGACCGCACGTTGAGATAGCA -> GAAGACCGCACGTTGAGATAGCAC
CTGTGACAGGGTACACACGTAATC -> TGTGACAGGGTACACACGTAATCC
ACTTTCGAATACATCAATCGTCGC -> CTTTCGAATACATCAATCGTCGCC
TTTGGTTATAGGACGTAAGGTGCC -> TTGGTTATAGGACGTAAGGTGCCA
CTGTCATACTTACCTTAAATCTTT -> TGTCATACTTACCTTAAATCTTTA
CAGGTCATTGCCTGCTTTAGGAAA -> AGGTCATTGCCTGCTTTAGGAAAT
CCGAGTTGTCTGGGCGTTCATCCC -> CGAGTTGTCTGGGCGTTCATCCCC
GCTGAGGTGACTGGATGGTCGGCA -> CTGAGGTGACTGGATGGTCGGCAC
CCACCCCCACATGTTCCCTGACAA -> CACCCCCACATGTTCCCTGACAAA
AGAGGGCAAATGGAACCTGGGACC -> GAGGGCAAATGGAACCTGGGACCC
GGTCCGAAGGCCCAGATGTATACA -> GTCCGAAGGCCCAGATGTATACAA
GCAGCGAACTCGTGCACATTCTCA -> CAGCGAACTCGTGCACATTCTCAC
TGTCTTGTCACAGCGTGGCGTTTG -> GTCTTGTCACAGCGTGGCGTTTGA
GGTATGGGGGCGATTGACTTCCCG -> GTATGGGGGCGATTGACTTCCCGG
ACTGTGACAGGGTACACACGTAAT -> CTGTGACAGGGTACACACGTAATC
GGTTGACAAAACGTGACATAGCTT -> GTTGACAAAACGTGACATAGCTTA
TTCATTGTTTCGTTGCCCCCGTCT -> TCATTGTTTCGTTGCCCCCGTCTT
GAGCACGGGTCAAATACTTTCGAA -> AGCACGGGTCAAATACTTTCGAAT
GTACCAGTTTAGCCTAAAGCAGGA -> TACCAGTTTAGCCTAAAGCAGGAC
AAACGCTTATTCGACTCACCTAAG -> AACGCTTATTCGACTCACCTAAGG
GCAGAACTGCGTAATGCTCGTAGC -> CAGAACTGCGTAATGCTCGTAGCA
AGCCCGCAGAACTGCGTAATGCTC -> GCCCGCAGAACTGCGTAATGCTCG
TTGAACAACCTTGTGCGGTCCGAA -> TGAACAACCTTGTGCGGTCCGAAG
TCTTGTCAGTAGCCATACTCCAAT -> CTTGTCAGTAGCCATACTCCAATG
CTTGTACAAGTATCAGCGCCATCG -> TTGTACAAGTATCAGCGCCATCGA
GGGTATGGGGGCGATTGACTTCCC -> GGTATGGGGGCGATTGACTTCCCG
CTAGTACTTTCCCGAAAATAAACC -> TAGTACTTTCCCGAAAATAAACCT
AAACGCCCACTCCATCTCTATACC -> AACGCCCACTCCATCTCTATACCC
TGTACAAGTATCAGCGCCATCGAT -> GTACAAGTATCAGCGCCATCGATG
CGTAGAGATTGGATCGCCGGTGAC -> GTAGAGATTGGATCGCCGGTGACG
TCTCCCTGGATCGAGAAGCTGCTG -> CTCCCTGGATCGAGAAGCTGCTGA
TCCCGGCCGTCCTGGGACCGGAAC -> CCCGGCCGTCCTGGGACCGGAACC
AGGATACACCTTGTTATCGCCTCC -> GGATACACCTTGTTATCGCCTCCT
ATCTGAAGGCTCTTCTGCGCGGTA -> TCTGAAGGCTCTTCTGCGCGGTAC
AGGCCACACGTGACATGGACGGCG -> GGCCACACGTGACATGGACGGCGA
GTTGTGTAGACGTAGAGATTGGAT -> TTGTGTAGACGTAGAGATTGGATC
TCCACATCCAAGGTCAAAGTGTGA -> CCACATCCAAGGTCAAAGTGTGAT
AGATTACGGTATGTGGGAGCAGCC -> GATTACGGTATGTGGGAGCAGCCC
GTGTTTAGCCGCGGAGAAGATGTC -> TGTTTAGCCGCGGAGAAGATGTCG
TACGGTATACCAATCAACTATGTT -> ACGGTATACCAATCAACTATGTTG
TCTAGGCCTTCACGTTTTGTTTAG -> CTAGGCCTTCACGTTTTGTTTAGA
CCAGTTTCAAATAAGACGAAATCT -> CAGTTTCAAATAAGACGAAATCTA
TGGGTGAGAGTAGTGGTCTCGGAA -> GGGTGAGAGTAGTGGTCTCGGAAC
AATGACTGTTACGAATGAGACATA -> ATGACTGTTACGAATGAGACATAT
CGATCCCAGATCGCGCTTACTGAC -> GATCCCAGATCGCGCTTACTGACA
GTTATCGCCTCCTTTGTCTCGTCA -> TTATCGCCTCCTTTGTCTCGTCAT
CAGTTTCAAATAAGACGAAATCTA -> AGTTTCAAATAAGACGAAATCTAA
TCATACTTACCTTAAATCTTTATG -> CATACTTACCTTAAATCTTTATGA
TACTCCAATGCCGAGTTGTCTGGG -> ACTCCAATGCCGAGTTGTCTGGGC
TGATCCTCTTCCATAAGATGATTC -> GATCCTCTTCCATAAGATGATTCA
ATCCGCAGAACCCGCGCTGCTAGG -> TCCGCAGAACCCGCGCTGCTAGGA
TAAGATAATCGCAACTTAAAGGCT -> AAGATAATCGCAACTTAAAGGCTT
GATCGCGCTTACTGACATTTTGGT -> ATCGCGCTTACTGACATTTTGGTT
TTGTCTCGTCATTCCGAAGTACAC -> TGTCTCGTCATTCCGAAGTACACT
AACTGCGTAATGCTCGTAGCAATA -> ACTGCGTAATGCTCGTAGCAATAT
CGATATTTGTGGAGCAAGGTCCTC -> GATATTTGTGGAGCAAGGTCCTCA
GCAGGACTTATCAAACCCACCAGT -> CAGGACTTATCAAACCCACCAGTA
GTAGTACCTGGCACCATTGGATTT -> TAGTACCTGGCACCATTGGATTTA
CTTGACATTTTGTCTTGTCACAGC -> TTGACATTTTGTCTTGTCACAGCG
AAACGCGTCATGGCGACTTGCCCA -> AACGCGTCATGGCGACTTGCCCAA
ACAACGCTTATAAACTTATCACCA -> CAACGCTTATAAACTTATCACCAC
TAACACAAAACGCGTCATGGCGAC -> AACACAAAACGCGTCATGGCGACT
ACTTGCATCTTGTCAGTAGCCATA -> CTTGCATCTTGTCAGTAGCCATAC
TTGCTCCACATCCAAGGTCAAAGT -> TGCTCCACATCCAAGGTCAAAGTG
TAAGATGATTCATTGTTTCGTTGC -> AAGATGATTCATTGTTTCGTTGCC
CCCGAAGCGGTTGACAAAACGTGA -> CCGAAGCGGTTGACAAAACGTGAC
CACCTGATCCTCTTCCATAAGATG -> ACCTGATCCTCTTCCATAAGATGA
TCAGGTCATTGCCTGCTTTAGGAA -> CAGGTCATTGCCTGCTTTAGGAAA
CATCAATCGTCGCCGCAGCGAACT -> ATCAATCGTCGCCGCAGCGAACTC
GATACACCTTGTTATCGCCTCCTT -> ATACACCTTGTTATCGCCTCCTTT
GGGCAAATGGAACCTGGGACCCCG -> GGCAAATGGAACCTGGGACCCCGC
TGTTTAGACCGGTAGTCCCAATTA -> GTTTAGACCGGTAGTCCCAATTAC
TTTGTGGAGCAAGGTCCTCACTTC -> TTGTGGAGCAAGGTCCTCACTTCG
ATATTTGTGGAGCAAGGTCCTCAC -> TATTTGTGGAGCAAGGTCCTCACT
CCAAGGTCAAAGTGTGATCACTAC -> CAAGGTCAAAGTGTGATCACTACT
GGCGTTCATCCCCATGCTCGTGGT -> GCGTTCATCCCCATGCTCGTGGTG
GTGTCTAAGATAATCGCAACTTAA -> TGTCTAAGATAATCGCAACTTAAA
CTAAAGCAGGACTTATCAAACCCA -> TAAAGCAGGACTTATCAAACCCAC
GATATTTGTGGAGCAAGGTCCTCA -> ATATTTGTGGAGCAAGGTCCTCAC
TGGGACCCCGCTAGTTTGACCAGT -> GGGACCCCGCTAGTTTGACCAGTC
GACAGGGTACACACGTAATCCGCA -> ACAGGGTACACACGTAATCCGCAG
GACCGCACGTTGAGATAGCACCTG -> ACCGCACGTTGAGATAGCACCTGA
GATGGGTGAGAGTAGTGGTCTCGG -> ATGGGTGAGAGTAGTGGTCTCGGA
ACACAAAACGCGTCATGGCGACTT -> CACAAAACGCGTCATGGCGACTTG
CATTTAACATGCCCAAAACGCTTA -> ATTTAACATGCCCAAAACGCTTAT
TTCGTTGCCCCCGTCTTCGGGTAG -> TCGTTGCCCCCGTCTTCGGGTAGG
AGGGCGCAATTTATGAGCACGGGT -> GGGCGCAATTTATGAGCACGGGTC
GCTGCTGATGGGTGAGAGTAGTGG -> CTGCTGATGGGTGAGAGTAGTGGT
CCTTGTACAAGTATCAGCGCCATC -> CTTGTACAAGTATCAGCGCCATCG
AGTTTGACCAGTCTCTCCCTGGAT -> GTTTGACCAGTCTCTCCCTGGATC
CTTACCTTAAATCTTTATGAGTTT -> TTACCTTAAATCTTTATGAGTTTC
GCATCTTGTCAGTAGCCATACTCC -> CATCTTGTCAGTAGCCATACTCCA
CCGGCTAACTATTTTCAGTGGCAG -> CGGCTAACTATTTTCAGTGGCAGT
CCATCTCTATACCCTGTCATACTT -> CATCTCTATACCCTGTCATACTTA
AATATGAGGGTCATTGTTAGGTGT -> ATATGAGGGTCATTGTTAGGTGTT
TAGCAATATCTACGGTACAAGTCG -> AGCAATATCTACGGTACAAGTCGG
TCTTCGGGTAGGTATCTTCTTCAA -> CTTCGGGTAGGTATCTTCTTCAAA
GCACGATCAGGCATATGCTGGAAT -> CACGATCAGGCATATGCTGGAATC
CCCGAAAATAAACCTTCCGGTCGC -> CCGAAAATAAACCTTCCGGTCGCT
CAGATGTATACAACGCTTATAAAC -> AGATGTATACAACGCTTATAAACT
GTAGGTATCTTCTTCAAACAATTC -> TAGGTATCTTCTTCAAACAATTCC
CTTACTGACATTTTGGTTATAGGA -> TTACTGACATTTTGGTTATAGGAC
TTGTTAGGTGTTTAGCCGCGGAGA -> TGTTAGGTGTTTAGCCGCGGAGAA
AGATTTCGGAACATATAACAATGA -> GATTTCGGAACATATAACAATGAG
CAGTTTCCCGCGTAATATTCATTT -> AGTTTCCCGCGTAATATTCATTTA
CTGAATCCATTAGGGCGCAATTTA -> TGAATCCATTAGGGCGCAATTTAT
GAATCGATTTCATACTGAATCCAT -> AATCGATTTCATACTGAATCCATT
GTAATCTTAGTACTCTAGGCCTTC -> TAATCTTAGTACTCTAGGCCTTCA
ATTTTGGTTATAGGACGTAAGGTG -> TTTTGGTTATAGGACGTAAGGTGC
CGCCGCAGCGAACTCGTGCACATT -> GCCGCAGCGAACTCGTGCACATTC
GGCCACACGTGACATGGACGGCGA -> GCCACACGTGACATGGACGGCGAG
TCGTAGCAATATCTACGGTACAAG -> CGTAGCAATATCTACGGTACAAGT
GCCTCCTTTGTCTCGTCATTCCGA -> CCTCCTTTGTCTCGTCATTCCGAA
TCGAGAAGCTGCTGATGGGTGAGA -> CGAGAAGCTGCTGATGGGTGAGAG
TACGAATGAGACATATTCCCGGTG -> ACGAATGAGACATATTCCCGGTGT
ATGGGTGAGAGTAGTGGTCTCGGA -> TGGGTGAGAGTAGTGGTCTCGGAA
TTAAGGCCTTACAAGTCAGGTCAT -> TAAGGCCTTACAAGTCAGGTCATT
GTAATCCGCAGAACCCGCGCTGCT -> TAATCCGCAGAACCCGCGCTGCTA
CGCGTAATATTCATTTAACATGCC -> GCGTAATATTCATTTAACATGCCC
GCGATTGACTTCCCGGCTAACTAT -> CGATTGACTTCCCGGCTAACTATT
ATTACGGTATGTGGGAGCAGCCCG -> TTACGGTATGTGGGAGCAGCCCGC
AAGGCCCAGATGTATACAACGCTT -> AGGCCCAGATGTATACAACGCTTA
CAACTATGTTGTGTAGACGTAGAG -> AACTATGTTGTGTAGACGTAGAGA
TGTTGTGTAGACGTAGAGATTGGA -> GTTGTGTAGACGTAGAGATTGGAT
CCATCATTACTCTAACATCTACCG -> CATCATTACTCTAACATCTACCGA
ACACCTTGTTATCGCCTCCTTTGT -> CACCTTGTTATCGCCTCCTTTGTC
TGTAGACGTAGAGATTGGATCGCC -> GTAGACGTAGAGATTGGATCGCCG
AAGGCCTTACAAGTCAGGTCATTG -> AGGCCTTACAAGTCAGGTCATTGC
TCCTTTGTCTCGTCATTCCGAAGT -> CCTTTGTCTCGTCATTCCGAAGTA
ACGGGTCAAATACTTTCGAATACA -> CGGGTCAAATACTTTCGAATACAT
GGAGAAGATGTCGACACATCCCTC -> GAGAAGATGTCGACACATCCCTCA
CCATTGGATTTAAGGCCTTACAAG -> CATTGGATTTAAGGCCTTACAAGT
GTGGGTATGGGGGCGATTGACTTC -> TGGGTATGGGGGCGATTGACTTCC
GAGCAAGGTCCTCACTTCGTCCTG -> AGCAAGGTCCTCACTTCGTCCTGT
CAGCTCTGTATATGTGCTAAACTG -> AGCTCTGTATATGTGCTAAACTGC
GACTTGCCCAAAATGTCCCGGCCG -> ACTTGCCCAAAATGTCCCGGCCGT
GTCTGGAAGGACACTTTTGAACAA -> TCTGGAAGGACACTTTTGAACAAC
CACTCCATCTCTATACCCTGTCAT -> ACTCCATCTCTATACCCTGTCATA
ATCTACGGTACAAGTCGGTAGGCC -> TCTACGGTACAAGTCGGTAGGCCA
GGGTAGGTATCTTCTTCAAACAAT -> GGTAGGTATCTTCTTCAAACAATT
GGTGCCTTGTACAAGTATCAGCGC -> GTGCCTTGTACAAGTATCAGCGCC
AGTAAATTTAGGGGCTGAGGTGAC -> GTAAATTTAGGGGCTGAGGTGACT
CGTGACATAGCTTAAACAGATTTC -> GTGACATAGCTTAAACAGATTTCG
GGGCTGAGGTGACTGGATGGTCGG -> GGCTGAGGTGACTGGATGGTCGGC
AGGGTATGGTTGCGCCACCCCCAC -> GGGTATGGTTGCGCCACCCCCACA
GTTTCAAATAAGACGAAATCTAAT -> TTTCAAATAAGACGAAATCTAATG
GTTATAGGACGTAAGGTGCCAGTT -> TTATAGGACGTAAGGTGCCAGTTT
ATACTCCAATGCCGAGTTGTCTGG -> TACTCCAATGCCGAGTTGTCTGGG
TCGTGCACATTCTCACCTGCAGTA -> CGTGCACATTCTCACCTGCAGTAA
CCGCACGTTGAGATAGCACCTGAT -> CGCACGTTGAGATAGCACCTGATC
GGCGTTTGAGGGTATGGTTGCGCC -> GCGTTTGAGGGTATGGTTGCGCCA
TTTAGGGGCTGAGGTGACTGGATG -> TTAGGGGCTGAGGTGACTGGATGG
AAATAAGACGAAATCTAATGACTG -> AATAAGACGAAATCTAATGACTGT
CGTGCACATTCTCACCTGCAGTAA -> GTGCACATTCTCACCTGCAGTAAA
ATAAACTTATCACCACCCTGCAAG -> TAAACTTATCACCACCCTGCAAGT
GGCACCATTGGATTTAAGGCCTTA -> GCACCATTGGATTTAAGGCCTTAC
CGGTATACCAATCAACTATGTTGT -> GGTATACCAATCAACTATGTTGTG
TGCCGAGTTGTCTGGGCGTTCATC -> GCCGAGTTGTCTGGGCGTTCATCC
TCGCCGCAGCGAACTCGTGCACAT -> CGCCGCAGCGAACTCGTGCACATT
CCGAAGTACACTTAGTATCCAGTT -> CGAAGTACACTTAGTATCCAGTTT
TTGCATCTTGTCAGTAGCCATACT -> TGCATCTTGTCAGTAGCCATACTC
TGAATCCATTAGGGCGCAATTTAT -> GAATCCATTAGGGCGCAATTTATG
TCGCGCTTACTGACATTTTGGTTA -> CGCGCTTACTGACATTTTGGTTAT
AAACAATTCCTTCGGAGTATTCGG -> AACAATTCCTTCGGAGTATTCGGC
AACTTAATATGAGGGTCATTGTTA -> ACTTAATATGAGGGTCATTGTTAG
TCCTCTTCCATAAGATGATTCATT -> CCTCTTCCATAAGATGATTCATTG
CGTAATGCTCGTAGCAATATCTAC -> GTAATGCTCGTAGCAATATCTACG
TTTTGAACAACCTTGTGCGGTCCG -> TTTGAACAACCTTGTGCGGTCCGA
TAGGCCACACGTGACATGGACGGC -> AGGCCACACGTGACATGGACGGCG
TTTCCCGAAAATAAACCTTCCGGT -> TTCCCGAAAATAAACCTTCCGGTC
TCGCTGCGCTTTGCTCCACATCCA -> CGCTGCGCTTTGCTCCACATCCAA
CATACTGAATCCATTAGGGCGCAA -> ATACTGAATCCATTAGGGCGCAAT
ATGCCCAAAACGCTTATTCGACTC -> TGCCCAAAACGCTTATTCGACTCA
GTGACATGGACGGCGAGGGGCGGC -> TGACATGGACGGCGAGGGGCGGCC
ATCATTACTCTAACATCTACCGAT -> TCATTACTCTAACATCTACCGATA
TTCGACTCACCTAAGGCCACCATC -> TCGACTCACCTAAGGCCACCATCA
TATAAACTTATCACCACCCTGCAA -> ATAAACTTATCACCACCCTGCAAG
AATACTTTCGAATACATCAATCGT -> ATACTTTCGAATACATCAATCGTC
ACCGAGAAGAATCGATTTCATACT -> CCGAGAAGAATCGATTTCATACTG
CCCACTCCATCTCTATACCCTGTC -> CCACTCCATCTCTATACCCTGTCA
CCCAAAGAATGTGCACTTGCATCT -> CCAAAGAATGTGCACTTGCATCTT
AGTTTCCTTAATACCGCACGATCA -> GTTTCCTTAATACCGCACGATCAG
CTTAGTATCCAGTTTCAAATAAGA -> TTAGTATCCAGTTTCAAATAAGAC
TACACTTAGTATCCAGTTTCAAAT -> ACACTTAGTATCCAGTTTCAAATA
AGAAGCTGCTGATGGGTGAGAGTA -> GAAGCTGCTGATGGGTGAGAGTAG
CCTCTTCCATAAGATGATTCATTG -> CTCTTCCATAAGATGATTCATTGT
ACCGGTAGTCCCAATTACTGGAGT -> CCGGTAGTCCCAATTACTGGAGTA
TCCGGTCGCTGCGCTTTGCTCCAC -> CCGGTCGCTGCGCTTTGCTCCACA
TGGTGTCCCTCGAATTTACAGCTC -> GGTGTCCCTCGAATTTACAGCTCT
GAATTTACAGCTCTGTATATGTGC -> AATTTACAGCTCTGTATATGTGCT
CATGTAGTACCTGGCACCATTGGA -> ATGTAGTACCTGGCACCATTGGAT
ACCATCATTACTCTAACATCTACC -> CCATCATTACTCTAACATCTACCG
CGCTACTTGGTGTCCCTCGAATTT -> GCTACTTGGTGTCCCTCGAATTTA
CCCTCGAATTTACAGCTCTGTATA -> CCTCGAATTTACAGCTCTGTATAT
TGCGCCACCCCCACATGTTCCCTG -> GCGCCACCCCCACATGTTCCCTGA
GGAGTATTCGGCTTACACACGCAT -> GAGTATTCGGCTTACACACGCATG
TTGACCAGTCTCTCCCTGGATCGA -> TGACCAGTCTCTCCCTGGATCGAG
ATCGATGCTTTAATAGTGGGTATG -> TCGATGCTTTAATAGTGGGTATGG
TACACCTTGTTATCGCCTCCTTTG -> ACACCTTGTTATCGCCTCCTTTGT
ATGGACGGCGAGGGGCGGCCCTAG -> TGGACGGCGAGGGGCGGCCCTAGT
CCGGTGTCTAAGATAATCGCAACT -> CGGTGTCTAAGATAATCGCAACTT
GTATATGTGCTAAACTGCGAGATT -> TATATGTGCTAAACTGCGAGATTA
ATCTAATGACTGTTACGAATGAGA -> TCTAATGACTGTTACGAATGAGAC
CATATTCCCGGTGTCTAAGATAAT -> ATATTCCCGGTGTCTAAGATAATC
AGCGTGGCGTTTGAGGGTATGGTT -> GCGTGGCGTTTGAGGGTATGGTTG
GAAGACCGCACGTTGAGATAGCAC -> AAGACCGCACGTTGAGATAGCACC
TACTTGGTGTCCCTCGAATTTACA -> ACTTGGTGTCCCTCGAATTTACAG
GTAGAGGGCAAATGGAACCTGGGA -> TAGAGGGCAAATGGAACCTGGGAC
GAACCGAGAAGAATCGATTTCATA -> AACCGAGAAGAATCGATTTCATAC
ATGCTCGTGGTGCCTTGTACAAGT -> TGCTCGTGGTGCCTTGTACAAGTA
TCTCTCCCTGGATCGAGAAGCTGC -> CTCTCCCTGGATCGAGAAGCTGCT
TATGTTGTGTAGACGTAGAGATTG -> ATGTTGTGTAGACGTAGAGATTGG
TGCCCCCGTCTTCGGGTAGGTATC -> GCCCCCGTCTTCGGGTAGGTATCT
CCAGTTTAGCCTAAAGCAGGACTT -> CAGTTTAGCCTAAAGCAGGACTTA
GCGAGGGGCGGCCCTAGTACTTTC -> CGAGGGGCGGCCCTAGTACTTTCC
TTCGGAACATATAACAATGAGGAT -> TCGGAACATATAACAATGAGGATA
AGACATTAGAAAACGCCCACTCCA -> GACATTAGAAAACGCCCACTCCAT
CCTTAATACCGCACGATCAGGCAT -> CTTAATACCGCACGATCAGGCATA
GACATGGACGGCGAGGGGCGGCCC -> ACATGGACGGCGAGGGGCGGCCCT
GTTGCCCCCGTCTTCGGGTAGGTA -> TTGCCCCCGTCTTCGGGTAGGTAT
TATAACAATGAGGATACACCTTGT -> ATAACAATGAGGATACACCTTGTT
GGACGTAAGGTGCCAGTTTCCCGC -> GACGTAAGGTGCCAGTTTCCCGCG
ACGTAGAGATTGGATCGCCGGTGA -> CGTAGAGATTGGATCGCCGGTGAC
AGTACGGGGCTCACTCCTCCGTCT -> GTACGGGGCTCACTCCTCCGTCTG
CTGGCACCATTGGATTTAAGGCCT -> TGGCACCATTGGATTTAAGGCCTT
TGGTGCCTTGTACAAGTATCAGCG -> GGTGCCTTGTACAAGTATCAGCGC
GCTTACTGACATTTTGGTTATAGG -> CTTACTGACATTTTGGTTATAGGA
TTGCCTGCTTTAGGAAATCTGAAG -> TGCCTGCTTTAGGAAATCTGAAGG
GATTTCGGAACATATAACAATGAG -> ATTTCGGAACATATAACAATGAGG
TTAACATGCCCAAAACGCTTATTC -> TAACATGCCCAAAACGCTTATTCG
GTCTGGGCGTTCATCCCCATGCTC -> TCTGGGCGTTCATCCCCATGCTCG
GGATCGCCGGTGACGCTACTTGGT -> GATCGCCGGTGACGCTACTTGGTG
GCCGCGGAGAAGATGTCGACACAT -> CCGCGGAGAAGATGTCGACACATC
GCGACTTGCCCAAAATGTCCCGGC -> CGACTTGCCCAAAATGTCCCGGCC
TTGTGGAGCAAGGTCCTCACTTCG -> TGTGGAGCAAGGTCCTCACTTCGT
CAAGGTCCTCACTTCGTCCTGTAG -> AAGGTCCTCACTTCGTCCTGTAGA
GCAATTTATGAGCACGGGTCAAAT -> CAATTTATGAGCACGGGTCAAATA
ATCTTAGTACTCTAGGCCTTCACG -> TCTTAGTACTCTAGGCCTTCACGT
TAAGGTGCCAGTTTCCCGCGTAAT -> AAGGTGCCAGTTTCCCGCGTAATA
ATGTAGTACCTGGCACCATTGGAT -> TGTAGTACCTGGCACCATTGGATT
GGAAATCTGAAGGCTCTTCTGCGC -> GAAATCTGAAGGCTCTTCTGCGCG
AAATACTTTCGAATACATCAATCG -> AATACTTTCGAATACATCAATCGT
TATCACCACCCTGCAAGTAGAGCC -> ATCACCACCCTGCAAGTAGAGCCG
AGCAATATCTACGGTACAAGTCGG -> GCAATATCTACGGTACAAGTCGGT
CAATTTATGAGCACGGGTCAAATA -> AATTTATGAGCACGGGTCAAATAC
CGGCGAGGGGCGGCCCTAGTACTT -> GGCGAGGGGCGGCCCTAGTACTTT
CTGTATATGTGCTAAACTGCGAGA -> TGTATATGTGCTAAACTGCGAGAT
TCAACTATGTTGTGTAGACGTAGA -> CAACTATGTTGTGTAGACGTAGAG
CATCTACCGATATTTGTGGAGCAA -> ATCTACCGATATTTGTGGAGCAAG
CGGAGAAGATGTCGACACATCCCT -> GGAGAAGATGTCGACACATCCCTC
GAACATATAACAATGAGGATACAC -> AACATATAACAATGAGGATACACC
CCACCCTGCAAGTAGAGCCGGAGT -> CACCCTGCAAGTAGAGCCGGAGTT
ACACGCATGTAGTACCTGGCACCA -> CACGCATGTAGTACCTGGCACCAT
TATTCCCGGTGTCTAAGATAATCG -> ATTCCCGGTGTCTAAGATAATCGC
GAGAAGAATCGATTTCATACTGAA -> AGAAGAATCGATTTCATACTGAAT
GTACAAGTATCAGCGCCATCGATG -> TACAAGTATCAGCGCCATCGATGC
GTGCACTTGCATCTTGTCAGTAGC -> TGCACTTGCATCTTGTCAGTAGCC
ATCTCTATACCCTGTCATACTTAC -> TCTCTATACCCTGTCATACTTACC
TACTTTCCCGAAAATAAACCTTCC -> ACTTTCCCGAAAATAAACCTTCCG
GACTCACCTAAGGCCACCATCATT -> ACTCACCTAAGGCCACCATCATTA
CTCGAATTTACAGCTCTGTATATG -> TCGAATTTACAGCTCTGTATATGT
TTTACAGCTCTGTATATGTGCTAA -> TTACAGCTCTGTATATGTGCTAAA
TATGAGGGTCATTGTTAGGTGTTT -> ATGAGGGTCATTGTTAGGTGTTTA
TGCTCGTAGCAATATCTACGGTAC -> GCTCGTAGCAATATCTACGGTACA
AGTAACACAAAACGCGTCATGGCG -> GTAACACAAAACGCGTCATGGCGA
ATAGCTTAAACAGATTTCGGAACA -> TAGCTTAAACAGATTTCGGAACAT
CGGCACGAACTTAATATGAGGGTC -> GGCACGAACTTAATATGAGGGTCA
CAACTTAAAGGCTTACGGTATACC -> AACTTAAAGGCTTACGGTATACCA
GGTGTCCCTCGAATTTACAGCTCT -> GTGTCCCTCGAATTTACAGCTCTG
CGTGAAGACCGCACGTTGAGATAG -> GTGAAGACCGCACGTTGAGATAGC
GCCCCCGTCTTCGGGTAGGTATCT -> CCCCCGTCTTCGGGTAGGTATCTT
TATTCGGCTTACACACGCATGTAG -> ATTCGGCTTACACACGCATGTAGT
TGAGGGTCATTGTTAGGTGTTTAG -> GAGGGTCATTGTTAGGTGTTTAGC
TGTTATCGCCTCCTTTGTCTCGTC -> GTTATCGCCTCCTTTGTCTCGTCA
TTCATACTGAATCCATTAGGGCGC -> TCATACTGAATCCATTAGGGCGCA
AAGAATGTGCACTTGCATCTTGTC -> AGAATGTGCACTTGCATCTTGTCA
GCGTGGCGTTTGAGGGTATGGTTG -> CGTGGCGTTTGAGGGTATGGTTGC
TAGCCTAAAGCAGGACTTATCAAA -> AGCCTAAAGCAGGACTTATCAAAC
TTCTTCAAACAATTCCTTCGGAGT -> TCTTCAAACAATTCCTTCGGAGTA
GCGAGATTACGGTATGTGGGAGCA -> CGAGATTACGGTATGTGGGAGCAG
AGTAGCCATACTCCAATGCCGAGT -> GTAGCCATACTCCAATGCCGAGTT
TTAATACCGCACGATCAGGCATAT -> TAATACCGCACGATCAGGCATATG
AGTCTCTCCCTGGATCGAGAAGCT -> GTCTCTCCCTGGATCGAGAAGCTG
TTTTGTCTTGTCACAGCGTGGCGT -> TTTGTCTTGTCACAGCGTGGCGTT
CTAAACTGCGAGATTACGGTATGT -> TAAACTGCGAGATTACGGTATGTG
ATTAGGGCGCAATTTATGAGCACG -> TTAGGGCGCAATTTATGAGCACGG
GAATACATCAATCGTCGCCGCAGC -> AATACATCAATCGTCGCCGCAGCG
GGCCCAGATGTATACAACGCTTAT -> GCCCAGATGTATACAACGCTTATA
TCGTGGTGCCTTGTACAAGTATCA -> CGTGGTGCCTTGTACAAGTATCAG
TTGTTATCGCCTCCTTTGTCTCGT -> TGTTATCGCCTCCTTTGTCTCGTC
TTTATGAGCACGGGTCAAATACTT -> TTATGAGCACGGGTCAAATACTTT
ACATATAACAATGAGGATACACCT -> CATATAACAATGAGGATACACCTT
TAGACGTAGAGATTGGATCGCCGG -> AGACGTAGAGATTGGATCGCCGGT
TTAAACAGATTTCGGAACATATAA -> TAAACAGATTTCGGAACATATAAC
GGTATACCAATCAACTATGTTGTG -> GTATACCAATCAACTATGTTGTGT
CAGTCTCTCCCTGGATCGAGAAGC -> AGTCTCTCCCTGGATCGAGAAGCT
TTGTCTTGTCACAGCGTGGCGTTT -> TGTCTTGTCACAGCGTGGCGTTTG
TCGTCCTGTAGAGGGCAAATGGAA -> CGTCCTGTAGAGGGCAAATGGAAC
TCCAATGCCGAGTTGTCTGGGCGT -> CCAATGCCGAGTTGTCTGGGCGTT
GTTACGAATGAGACATATTCCCGG -> TTACGAATGAGACATATTCCCGGT
AGCGAACTCGTGCACATTCTCACC -> GCGAACTCGTGCACATTCTCACCT
TAGTGGGTATGGGGGCGATTGACT -> AGTGGGTATGGGGGCGATTGACTT
CTTGCATCTTGTCAGTAGCCATAC -> TTGCATCTTGTCAGTAGCCATACT
ACCCACCAGTATACCCAAAGAATG -> CCCACCAGTATACCCAAAGAATGT
CAGGACTTATCAAACCCACCAGTA -> AGGACTTATCAAACCCACCAGTAT
TTCCCTGACAAATGCCGTTTCGCT -> TCCCTGACAAATGCCGTTTCGCTT
GGAGCCCGAAGCGGTTGACAAAAC -> GAGCCCGAAGCGGTTGACAAAACG
TGGGAGCAGCCCGCAGAACTGCGT -> GGGAGCAGCCCGCAGAACTGCGTA
CGTAATCCGCAGAACCCGCGCTGC -> GTAATCCGCAGAACCCGCGCTGCT
AAACTGCGAGATTACGGTATGTGG -> AACTGCGAGATTACGGTATGTGGG
CGTTTGAGGGTATGGTTGCGCCAC -> GTTTGAGGGTATGGTTGCGCCACC
TGTTAGGTGTTTAGCCGCGGAGAA -> GTTAGGTGTTTAGCCGCGGAGAAG
TGACATAGCTTAAACAGATTTCGG -> GACATAGCTTAAACAGATTTCGGA
CTTAATATGAGGGTCATTGTTAGG -> TTAATATGAGGGTCATTGTTAGGT
TTACGGTATGTGGGAGCAGCCCGC -> TACGGTATGTGGGAGCAGCCCGCA
GCCCGAAGCGGTTGACAAAACGTG -> CCCGAAGCGGTTGACAAAACGTGA
CCGCAGCGAACTCGTGCACATTCT -> CGCAGCGAACTCGTGCACATTCTC
TCTTAGTACTCTAGGCCTTCACGT -> CTTAGTACTCTAGGCCTTCACGTT
TTTGACCAGTCTCTCCCTGGATCG -> TTGACCAGTCTCTCCCTGGATCGA
TCGGGTAGGTATCTTCTTCAAACA -> CGGGTAGGTATCTTCTTCAAACAA
AGACCGCACGTTGAGATAGCACCT -> GACCGCACGTTGAGATAGCACCTG
CGCCCACTCCATCTCTATACCCTG -> GCCCACTCCATCTCTATACCCTGT
ATCGCCTCCTTTGTCTCGTCATTC -> TCGCCTCCTTTGTCTCGTCATTCC
GCGGTCCGAAGGCCCAGATGTATA -> CGGTCCGAAGGCCCAGATGTATAC
ATTTGTGGAGCAAGGTCCTCACTT -> TTTGTGGAGCAAGGTCCTCACTTC
GTTGACAAAACGTGACATAGCTTA -> TTGACAAAACGTGACATAGCTTAA
GTGGTGCCTTGTACAAGTATCAGC -> TGGTGCCTTGTACAAGTATCAGCG
AAGATGTCGACACATCCCTCAAGT -> AGATGTCGACACATCCCTCAAGTA
TCCCTGACAAATGCCGTTTCGCTT -> CCCTGACAAATGCCGTTTCGCTTG
AACGTGACATAGCTTAAACAGATT -> ACGTGACATAGCTTAAACAGATTT
GCAACTTAAAGGCTTACGGTATAC -> CAACTTAAAGGCTTACGGTATACC
TTGGTTATAGGACGTAAGGTGCCA -> TGGTTATAGGACGTAAGGTGCCAG
ATACTTTCGAATACATCAATCGTC -> TACTTTCGAATACATCAATCGTCG
GTAGCCATACTCCAATGCCGAGTT -> TAGCCATACTCCAATGCCGAGTTG
ACTTTCCCGAAAATAAACCTTCCG -> CTTTCCCGAAAATAAACCTTCCGG
TTGCCCAAAATGTCCCGGCCGTCC -> TGCCCAAAATGTCCCGGCCGTCCT
CGTAATATTCATTTAACATGCCCA -> GTAATATTCATTTAACATGCCCAA
TCCTCACTTCGTCCTGTAGAGGGC -> CCTCACTTCGTCCTGTAGAGGGCA
GCCGGAGTTCGGTAATCTTAGTAC -> CCGGAGTTCGGTAATCTTAGTACT
AGCTGCTGATGGGTGAGAGTAGTG -> GCTGCTGATGGGTGAGAGTAGTGG
CCACCATCATTACTCTAACATCTA -> CACCATCATTACTCTAACATCTAC
TTCCTTAATACCGCACGATCAGGC -> TCCTTAATACCGCACGATCAGGCA
CGCCATCGATGCTTTAATAGTGGG -> GCCATCGATGCTTTAATAGTGGGT
CATTAGAAAACGCCCACTCCATCT -> ATTAGAAAACGCCCACTCCATCTC
TAATAGTGGGTATGGGGGCGATTG -> AATAGTGGGTATGGGGGCGATTGA
ACTTACCTTAAATCTTTATGAGTT -> CTTACCTTAAATCTTTATGAGTTT
GGCCTTCACGTTTTGTTTAGACCG -> GCCTTCACGTTTTGTTTAGACCGG
GTTCGGTAATCTTAGTACTCTAGG -> TTCGGTAATCTTAGTACTCTAGGC
ATTCTCACCTGCAGTAAATTTAGG -> TTCTCACCTGCAGTAAATTTAGGG
AACCTGGGACCCCGCTAGTTTGAC -> ACCTGGGACCCCGCTAGTTTGACC
ATGTGGGAGCAGCCCGCAGAACTG -> TGTGGGAGCAGCCCGCAGAACTGC
TCCCCATGCTCGTGGTGCCTTGTA -> CCCCATGCTCGTGGTGCCTTGTAC
TGTTTCGTTGCCCCCGTCTTCGGG -> GTTTCGTTGCCCCCGTCTTCGGGT
CATTAGGGCGCAATTTATGAGCAC -> ATTAGGGCGCAATTTATGAGCACG
GACACTTTTGAACAACCTTGTGCG -> ACACTTTTGAACAACCTTGTGCGG
GCGCCATCGATGCTTTAATAGTGG -> CGCCATCGATGCTTTAATAGTGGG
AACGCTTATAAACTTATCACCACC -> ACGCTTATAAACTTATCACCACCC
TCTGGGCGTTCATCCCCATGCTCG -> CTGGGCGTTCATCCCCATGCTCGT
GGTAATCTTAGTACTCTAGGCCTT -> GTAATCTTAGTACTCTAGGCCTTC
TAGTCCCAATTACTGGAGTAACAC -> AGTCCCAATTACTGGAGTAACACA
CTCGTGGTGCCTTGTACAAGTATC -> TCGTGGTGCCTTGTACAAGTATCA
GTCAGTAGCCATACTCCAATGCCG -> TCAGTAGCCATACTCCAATGCCGA
GCCTGCTTTAGGAAATCTGAAGGC -> CCTGCTTTAGGAAATCTGAAGGCT
AATCTGAAGGCTCTTCTGCGCGGT -> ATCTGAAGGCTCTTCTGCGCGGTA
AAATAAACCTTCCGGTCGCTGCGC -> AATAAACCTTCCGGTCGCTGCGCT
TGTCTGGGCGTTCATCCCCATGCT -> GTCTGGGCGTTCATCCCCATGCTC
GTACACACGTAATCCGCAGAACCC -> TACACACGTAATCCGCAGAACCCG
TCAGTGGCAGTACGGGGCTCACTC -> CAGTGGCAGTACGGGGCTCACTCC
TTTCCTTAATACCGCACGATCAGG -> TTCCTTAATACCGCACGATCAGGC
GGTCGCTGCGCTTTGCTCCACATC -> GTCGCTGCGCTTTGCTCCACATCC
GGAATCTTGACATTTTGTCTTGTC -> GAATCTTGACATTTTGTCTTGTCA
GCTCACTCCTCCGTCTGGAAGGAC -> CTCACTCCTCCGTCTGGAAGGACA
AGATGTATACAACGCTTATAAACT -> GATGTATACAACGCTTATAAACTT
GAAGATGTCGACACATCCCTCAAG -> AAGATGTCGACACATCCCTCAAGT
CTCTAACATCTACCGATATTTGTG -> TCTAACATCTACCGATATTTGTGG
TGACTGGATGGTCGGCACGAACTT -> GACTGGATGGTCGGCACGAACTTA
CCTGTAGAGGGCAAATGGAACCTG -> CTGTAGAGGGCAAATGGAACCTGG
ATCCCTCAAGTAACTGTGACAGGG -> TCCCTCAAGTAACTGTGACAGGGT
GGCGATTGACTTCCCGGCTAACTA -> GCGATTGACTTCCCGGCTAACTAT
ACGCTTATTCGACTCACCTAAGGC -> CGCTTATTCGACTCACCTAAGGCC
ACGTGACATGGACGGCGAGGGGCG -> CGTGACATGGACGGCGAGGGGCGG
TTTAGACCGGTAGTCCCAATTACT -> TTAGACCGGTAGTCCCAATTACTG
GCCCGCAGAACTGCGTAATGCTCG -> CCCGCAGAACTGCGTAATGCTCGT
CCTAGTACTTTCCCGAAAATAAAC -> CTAGTACTTTCCCGAAAATAAACC
TAAACTTATCACCACCCTGCAAGT -> AAACTTATCACCACCCTGCAAGTA
CTAATGACTGTTACGAATGAGACA -> TAATGACTGTTACGAATGAGACAT
CCCGTCTTCGGGTAGGTATCTTCT -> CCGTCTTCGGGTAGGTATCTTCTT
AATGGAACCTGGGACCCCGCTAGT -> ATGGAACCTGGGACCCCGCTAGTT
AACAGATTTCGGAACATATAACAA -> ACAGATTTCGGAACATATAACAAT
ATGCCGTTTCGCTTGATATCAGCT -> TGCCGTTTCGCTTGATATCAGCTG
GTAACTGTGACAGGGTACACACGT -> TAACTGTGACAGGGTACACACGTA
AATGCCGTTTCGCTTGATATCAGC -> ATGCCGTTTCGCTTGATATCAGCT
TTATTCGACTCACCTAAGGCCACC -> TATTCGACTCACCTAAGGCCACCA
GGACCCCGCTAGTTTGACCAGTCT -> GACCCCGCTAGTTTGACCAGTCTC
GCACTTGCATCTTGTCAGTAGCCA -> CACTTGCATCTTGTCAGTAGCCAT
ACGTAATCCGCAGAACCCGCGCTG -> CGTAATCCGCAGAACCCGCGCTGC
CTCTTCCATAAGATGATTCATTGT -> TCTTCCATAAGATGATTCATTGTT
AGGCTTACGGTATACCAATCAACT -> GGCTTACGGTATACCAATCAACTA
CGCGCTTACTGACATTTTGGTTAT -> GCGCTTACTGACATTTTGGTTATA
CATTGTTAGGTGTTTAGCCGCGGA -> ATTGTTAGGTGTTTAGCCGCGGAG
GTCATACTTACCTTAAATCTTTAT -> TCATACTTACCTTAAATCTTTATG
TCCTTCGGAGTATTCGGCTTACAC -> CCTTCGGAGTATTCGGCTTACACA
CATCTTGTCAGTAGCCATACTCCA -> ATCTTGTCAGTAGCCATACTCCAA
GCCCAAAACGCTTATTCGACTCAC -> CCCAAAACGCTTATTCGACTCACC
AGGTCCTCACTTCGTCCTGTAGAG -> GGTCCTCACTTCGTCCTGTAGAGG
CCGAAGGCCCAGATGTATACAACG -> CGAAGGCCCAGATGTATACAACGC
CGCGGTACCAGTTTAGCCTAAAGC -> GCGGTACCAGTTTAGCCTAAAGCA
CGTTTTGTTTAGACCGGTAGTCCC -> GTTTTGTTTAGACCGGTAGTCCCA
ACCTTAAATCTTTATGAGTTTCCT -> CCTTAAATCTTTATGAGTTTCCTT
ATAAGATGATTCATTGTTTCGTTG -> TAAGATGATTCATTGTTTCGTTGC
AAGGTCCTCACTTCGTCCTGTAGA -> AGGTCCTCACTTCGTCCTGTAGAG
AGCGCCATCGATGCTTTAATAGTG -> GCGCCATCGATGCTTTAATAGTGG
TAAATCTTTATGAGTTTCCTTAAT -> AAATCTTTATGAGTTTCCTTAATA
TTCGTCCTGTAGAGGGCAAATGGA -> TCGTCCTGTAGAGGGCAAATGGAA
ATTCGACTCACCTAAGGCCACCAT -> TTCGACTCACCTAAGGCCACCATC
CCGGAGTTCGGTAATCTTAGTACT -> CGGAGTTCGGTAATCTTAGTACTC
GAGTTGTCTGGGCGTTCATCCCCA -> AGTTGTCTGGGCGTTCATCCCCAT
CACGCATGTAGTACCTGGCACCAT -> ACGCATGTAGTACCTGGCACCATT
CCAGTTTCCCGCGTAATATTCATT -> CAGTTTCCCGCGTAATATTCATTT
TGCGGTCCGAAGGCCCAGATGTAT -> GCGGTCCGAAGGCCCAGATGTATA
TTGACAAAACGTGACATAGCTTAA -> TGACAAAACGTGACATAGCTTAAA
GGGTGAGAGTAGTGGTCTCGGAAC -> GGTGAGAGTAGTGGTCTCGGAACG
ACTGTTACGAATGAGACATATTCC -> CTGTTACGAATGAGACATATTCCC
GACGTAGAGATTGGATCGCCGGTG -> ACGTAGAGATTGGATCGCCGGTGA
GTGCGGTCCGAAGGCCCAGATGTA -> TGCGGTCCGAAGGCCCAGATGTAT
CCCTGCAAGTAGAGCCGGAGTTCG -> CCTGCAAGTAGAGCCGGAGTTCGG
TCGAATACATCAATCGTCGCCGCA -> CGAATACATCAATCGTCGCCGCAG
AAACCTTCCGGTCGCTGCGCTTTG -> AACCTTCCGGTCGCTGCGCTTTGC
TAATCCGCAGAACCCGCGCTGCTA -> AATCCGCAGAACCCGCGCTGCTAG
GGTCAAAGTGTGATCACTACTTCT -> GTCAAAGTGTGATCACTACTTCTT
CATTGCCTGCTTTAGGAAATCTGA -> ATTGCCTGCTTTAGGAAATCTGAA
TTAAAGGCTTACGGTATACCAATC -> TAAAGGCTTACGGTATACCAATCA
CTGCGCGGTACCAGTTTAGCCTAA -> TGCGCGGTACCAGTTTAGCCTAAA
GTTTCCCGCGTAATATTCATTTAA -> TTTCCCGCGTAATATTCATTTAAC
CTCCACATCCAAGGTCAAAGTGTG -> TCCACATCCAAGGTCAAAGTGTGA
TCTACCGATATTTGTGGAGCAAGG -> CTACCGATATTTGTGGAGCAAGGT
GTAGCAATATCTACGGTACAAGTC -> TAGCAATATCTACGGTACAAGTCG
AGCCCGAAGCGGTTGACAAAACGT -> GCCCGAAGCGGTTGACAAAACGTG
TGCAGTAAATTTAGGGGCTGAGGT -> GCAGTAAATTTAGGGGCTGAGGTG
ATTCCCGGTGTCTAAGATAATCGC -> TTCCCGGTGTCTAAGATAATCGCA
GATGTATACAACGCTTATAAACTT -> ATGTATACAACGCTTATAAACTTA
CGCCGGTGACGCTACTTGGTGTCC -> GCCGGTGACGCTACTTGGTGTCCC
AGGCATATGCTGGAATCTTGACAT -> GGCATATGCTGGAATCTTGACATT
GCTTGATATCAGCTGGTCCACGAT -> CTTGATATCAGCTGGTCCACGATC
CGGTCCGAAGGCCCAGATGTATAC -> GGTCCGAAGGCCCAGATGTATACA
AATTTATGAGCACGGGTCAAATAC -> ATTTATGAGCACGGGTCAAATACT
CACCTTGTTATCGCCTCCTTTGTC -> ACCTTGTTATCGCCTCCTTTGTCT
GCACGTTGAGATAGCACCTGATCC -> CACGTTGAGATAGCACCTGATCCT
GAGTAGTGGTCTCGGAACGTGAAG -> AGTAGTGGTCTCGGAACGTGAAGA
ATTGTTAGGTGTTTAGCCGCGGAG -> TTGTTAGGTGTTTAGCCGCGGAGA
CGAGTTGTCTGGGCGTTCATCCCC -> GAGTTGTCTGGGCGTTCATCCCCA
CGGGTCAAATACTTTCGAATACAT -> GGGTCAAATACTTTCGAATACATC
GCTTAAACAGATTTCGGAACATAT -> CTTAAACAGATTTCGGAACATATA
TTGAGGGTATGGTTGCGCCACCCC -> TGAGGGTATGGTTGCGCCACCCCC
AACAACCTTGTGCGGTCCGAAGGC -> ACAACCTTGTGCGGTCCGAAGGCC
TTATCACCACCCTGCAAGTAGAGC -> TATCACCACCCTGCAAGTAGAGCC
TGTATATGTGCTAAACTGCGAGAT -> GTATATGTGCTAAACTGCGAGATT
GCCCAAAATGTCCCGGCCGTCCTG -> CCCAAAATGTCCCGGCCGTCCTGG
GGCGGCCCTAGTACTTTCCCGAAA -> GCGGCCCTAGTACTTTCCCGAAAA
GACGGCGAGGGGCGGCCCTAGTAC -> ACGGCGAGGGGCGGCCCTAGTACT
GGGCTCACTCCTCCGTCTGGAAGG -> GGCTCACTCCTCCGTCTGGAAGGA
GACATTTTGTCTTGTCACAGCGTG -> ACATTTTGTCTTGTCACAGCGTGG
GTATCTTCTTCAAACAATTCCTTC -> TATCTTCTTCAAACAATTCCTTCG
CAAGTCGGTAGGCCACACGTGACA -> AAGTCGGTAGGCCACACGTGACAT
GTCTCGTCATTCCGAAGTACACTT -> TCTCGTCATTCCGAAGTACACTTA
TTATCGCCTCCTTTGTCTCGTCAT -> TATCGCCTCCTTTGTCTCGTCATT
TGCGCGGTACCAGTTTAGCCTAAA -> GCGCGGTACCAGTTTAGCCTAAAG
TGGATCGCCGGTGACGCTACTTGG -> GGATCGCCGGTGACGCTACTTGGT
CTGCAGTAAATTTAGGGGCTGAGG -> TGCAGTAAATTTAGGGGCTGAGGT
GCGGCCCTAGTACTTTCCCGAAAA -> CGGCCCTAGTACTTTCCCGAAAAT
GGTACACACGTAATCCGCAGAACC -> GTACACACGTAATCCGCAGAACCC
TGAGGATACACCTTGTTATCGCCT -> GAGGATACACCTTGTTATCGCCTC
AGGACACTTTTGAACAACCTTGTG -> GGACACTTTTGAACAACCTTGTGC
CGTGGCGTTTGAGGGTATGGTTGC -> GTGGCGTTTGAGGGTATGGTTGCG
ACTCCTCCGTCTGGAAGGACACTT -> CTCCTCCGTCTGGAAGGACACTTT
CCTGCAGTAAATTTAGGGGCTGAG -> CTGCAGTAAATTTAGGGGCTGAGG
TCGGCACGAACTTAATATGAGGGT -> CGGCACGAACTTAATATGAGGGTC
TTCCGGTCGCTGCGCTTTGCTCCA -> TCCGGTCGCTGCGCTTTGCTCCAC
CGAAATCTAATGACTGTTACGAAT -> GAAATCTAATGACTGTTACGAATG
CTTCTGCGCGGTACCAGTTTAGCC -> TTCTGCGCGGTACCAGTTTAGCCT
GTAAGGTGCCAGTTTCCCGCGTAA -> TAAGGTGCCAGTTTCCCGCGTAAT
ACACTTAGTATCCAGTTTCAAATA -> CACTTAGTATCCAGTTTCAAATAA
ACCGGAACCGAGAAGAATCGATTT -> CCGGAACCGAGAAGAATCGATTTC
GGGCGGCCCTAGTACTTTCCCGAA -> GGCGGCCCTAGTACTTTCCCGAAA
AAATGTCCCGGCCGTCCTGGGACC -> AATGTCCCGGCCGTCCTGGGACCG
ATGATTCATTGTTTCGTTGCCCCC -> TGATTCATTGTTTCGTTGCCCCCG
AGATCGCGCTTACTGACATTTTGG -> GATCGCGCTTACTGACATTTTGGT
CATCCCCATGCTCGTGGTGCCTTG -> ATCCCCATGCTCGTGGTGCCTTGT
TCACCTAAGGCCACCATCATTACT -> CACCTAAGGCCACCATCATTACTC
CGGAACATATAACAATGAGGATAC -> GGAACATATAACAATGAGGATACA
CGAAGGCCCAGATGTATACAACGC -> GAAGGCCCAGATGTATACAACGCT
TTGGATCGCCGGTGACGCTACTTG -> TGGATCGCCGGTGACGCTACTTGG
GAAGCGGTTGACAAAACGTGACAT -> AAGCGGTTGACAAAACGTGACATA
TTTCGGAACATATAACAATGAGGA -> TTCGGAACATATAACAATGAGGAT
TAGTACTCTAGGCCTTCACGTTTT -> AGTACTCTAGGCCTTCACGTTTTG
CTCGTCATTCCGAAGTACACTTAG -> TCGTCATTCCGAAGTACACTTAGT
TCCCGAAAATAAACCTTCCGGTCG -> CCCGAAAATAAACCTTCCGGTCGC
TGGTCTCGGAACGTGAAGACCGCA -> GGTCTCGGAACGTGAAGACCGCAC
GAGTTCGGTAATCTTAGTACTCTA -> AGTTCGGTAATCTTAGTACTCTAG
ATTTAACATGCCCAAAACGCTTAT -> TTTAACATGCCCAAAACGCTTATT
AATCGTCGCCGCAGCGAACTCGTG -> ATCGTCGCCGCAGCGAACTCGTGC
ATCAGCGCCATCGATGCTTTAATA -> TCAGCGCCATCGATGCTTTAATAG
ACCTTGTGCGGTCCGAAGGCCCAG -> CCTTGTGCGGTCCGAAGGCCCAGA
TACTGGAGTAACACAAAACGCGTC -> ACTGGAGTAACACAAAACGCGTCA
GGAACGTGAAGACCGCACGTTGAG -> GAACGTGAAGACCGCACGTTGAGA
ATGAGTTTCCTTAATACCGCACGA -> TGAGTTTCCTTAATACCGCACGAT
AATACATCAATCGTCGCCGCAGCG -> ATACATCAATCGTCGCCGCAGCGA
GCTAGGAGCCCGAAGCGGTTGACA -> CTAGGAGCCCGAAGCGGTTGACAA
GTCTCTCCCTGGATCGAGAAGCTG -> TCTCTCCCTGGATCGAGAAGCTGC
GGCTGAGGTGACTGGATGGTCGGC -> GCTGAGGTGACTGGATGGTCGGCA
GATATCAGCTGGTCCACGATCCCA -> ATATCAGCTGGTCCACGATCCCAG
TCCCAATTACTGGAGTAACACAAA -> CCCAATTACTGGAGTAACACAAAA
CGGGTAGGTATCTTCTTCAAACAA -> GGGTAGGTATCTTCTTCAAACAAT
GCCACCCCCACATGTTCCCTGACA -> CCACCCCCACATGTTCCCTGACAA
CGAATGAGACATATTCCCGGTGTC -> GAATGAGACATATTCCCGGTGTCT
TTGTCACAGCGTGGCGTTTGAGGG -> TGTCACAGCGTGGCGTTTGAGGGT
TACCCAAAGAATGTGCACTTGCAT -> ACCCAAAGAATGTGCACTTGCATC
GTCATTCCGAAGTACACTTAGTAT -> TCATTCCGAAGTACACTTAGTATC
ACCCCCACATGTTCCCTGACAAAT -> CCCCCACATGTTCCCTGACAAATG
TTTGAACAACCTTGTGCGGTCCGA -> TTGAACAACCTTGTGCGGTCCGAA
CACGGGTCAAATACTTTCGAATAC -> ACGGGTCAAATACTTTCGAATACA
TTGTTTCGTTGCCCCCGTCTTCGG -> TGTTTCGTTGCCCCCGTCTTCGGG
TTCCTTCGGAGTATTCGGCTTACA -> TCCTTCGGAGTATTCGGCTTACAC
CCGCTAGTTTGACCAGTCTCTCCC -> CGCTAGTTTGACCAGTCTCTCCCT
GAGGTGACTGGATGGTCGGCACGA -> AGGTGACTGGATGGTCGGCACGAA
GGGGCTGAGGTGACTGGATGGTCG -> GGGCTGAGGTGACTGGATGGTCGG
CCAGTATACCCAAAGAATGTGCAC -> CAGTATACCCAAAGAATGTGCACT
CAAGTAACTGTGACAGGGTACACA -> AAGTAACTGTGACAGGGTACACAC
CACCAGTATACCCAAAGAATGTGC -> ACCAGTATACCCAAAGAATGTGCA
AAAATGTCCCGGCCGTCCTGGGAC -> AAATGTCCCGGCCGTCCTGGGACC
CCTCACTTCGTCCTGTAGAGGGCA -> CTCACTTCGTCCTGTAGAGGGCAA
AATAAACCTTCCGGTCGCTGCGCT -> ATAAACCTTCCGGTCGCTGCGCTT
ATAACAATGAGGATACACCTTGTT -> TAACAATGAGGATACACCTTGTTA
GTAAATTTAGGGGCTGAGGTGACT -> TAAATTTAGGGGCTGAGGTGACTG
CTAGGAGCCCGAAGCGGTTGACAA -> TAGGAGCCCGAAGCGGTTGACAAA
CAACGCTTATAAACTTATCACCAC -> AACGCTTATAAACTTATCACCACC
TAATGACTGTTACGAATGAGACAT -> AATGACTGTTACGAATGAGACATA
AATCAACTATGTTGTGTAGACGTA -> ATCAACTATGTTGTGTAGACGTAG
GCCGTTTCGCTTGATATCAGCTGG -> CCGTTTCGCTTGATATCAGCTGGT
TCGCTTGATATCAGCTGGTCCACG -> CGCTTGATATCAGCTGGTCCACGA
TGACATTTTGTCTTGTCACAGCGT -> GACATTTTGTCTTGTCACAGCGTG
CCCACATGTTCCCTGACAAATGCC -> CCACATGTTCCCTGACAAATGCCG
ATATTCCCGGTGTCTAAGATAATC -> TATTCCCGGTGTCTAAGATAATCG
CTGGGCGTTCATCCCCATGCTCGT -> TGGGCGTTCATCCCCATGCTCGTG
TTCGGCTTACACACGCATGTAGTA -> TCGGCTTACACACGCATGTAGTAC
ACAAGTCAGGTCATTGCCTGCTTT -> CAAGTCAGGTCATTGCCTGCTTTA
CCCGCGCTGCTAGGAGCCCGAAGC -> CCGCGCTGCTAGGAGCCCGAAGCG
CCACGATCCCAGATCGCGCTTACT -> CACGATCCCAGATCGCGCTTACTG
TTCCCGGCTAACTATTTTCAGTGG -> TCCCGGCTAACTATTTTCAGTGGC
CGCAGAACTGCGTAATGCTCGTAG -> GCAGAACTGCGTAATGCTCGTAGC
TGTGCGGTCCGAAGGCCCAGATGT -> GTGCGGTCCGAAGGCCCAGATGTA
GGGGGCGATTGACTTCCCGGCTAA -> GGGGCGATTGACTTCCCGGCTAAC
GTCATGGCGACTTGCCCAAAATGT -> TCATGGCGACTTGCCCAAAATGTC
ACCTGCAGTAAATTTAGGGGCTGA -> CCTGCAGTAAATTTAGGGGCTGAG
GACCGGTAGTCCCAATTACTGGAG -> ACCGGTAGTCCCAATTACTGGAGT
TATGTGCTAAACTGCGAGATTACG -> ATGTGCTAAACTGCGAGATTACGG
GGAGCAAGGTCCTCACTTCGTCCT -> GAGCAAGGTCCTCACTTCGTCCTG
ATGCTTTAATAGTGGGTATGGGGG -> TGCTTTAATAGTGGGTATGGGGGC
AGTACTCTAGGCCTTCACGTTTTG -> GTACTCTAGGCCTTCACGTTTTGT
AACATGCCCAAAACGCTTATTCGA -> ACATGCCCAAAACGCTTATTCGAC
TACCTTAAATCTTTATGAGTTTCC -> ACCTTAAATCTTTATGAGTTTCCT
ACGGTACAAGTCGGTAGGCCACAC -> CGGTACAAGTCGGTAGGCCACACG
ACTGCGTAATGCTCGTAGCAATAT -> CTGCGTAATGCTCGTAGCAATATC
TGAAGGCTCTTCTGCGCGGTACCA -> GAAGGCTCTTCTGCGCGGTACCAG
CCATAAGATGATTCATTGTTTCGT -> CATAAGATGATTCATTGTTTCGTT
CGGTACAAGTCGGTAGGCCACACG -> GGTACAAGTCGGTAGGCCACACGT
GAAATCTAATGACTGTTACGAATG -> AAATCTAATGACTGTTACGAATGA
CTGATCCTCTTCCATAAGATGATT -> TGATCCTCTTCCATAAGATGATTC
TGGAACCTGGGACCCCGCTAGTTT -> GGAACCTGGGACCCCGCTAGTTTG
ACATCCCTCAAGTAACTGTGACAG -> CATCCCTCAAGTAACTGTGACAGG
GATTTAAGGCCTTACAAGTCAGGT -> ATTTAAGGCCTTACAAGTCAGGTC
CAATCGTCGCCGCAGCGAACTCGT -> AATCGTCGCCGCAGCGAACTCGTG
ACGCGTCATGGCGACTTGCCCAAA -> CGCGTCATGGCGACTTGCCCAAAA
GGTCCACGATCCCAGATCGCGCTT -> GTCCACGATCCCAGATCGCGCTTA
GTACTCTAGGCCTTCACGTTTTGT -> TACTCTAGGCCTTCACGTTTTGTT
GATTGACTTCCCGGCTAACTATTT -> ATTGACTTCCCGGCTAACTATTTT
ACCCCGCTAGTTTGACCAGTCTCT -> CCCCGCTAGTTTGACCAGTCTCTC
CGTCCTGTAGAGGGCAAATGGAAC -> GTCCTGTAGAGGGCAAATGGAACC
TAGTTTGACCAGTCTCTCCCTGGA -> AGTTTGACCAGTCTCTCCCTGGAT
TCCCTCGAATTTACAGCTCTGTAT -> CCCTCGAATTTACAGCTCTGTATA
GTCGCCGCAGCGAACTCGTGCACA -> TCGCCGCAGCGAACTCGTGCACAT
ACTCCAATGCCGAGTTGTCTGGGC -> CTCCAATGCCGAGTTGTCTGGGCG
AAATCTGAAGGCTCTTCTGCGCGG -> AATCTGAAGGCTCTTCTGCGCGGT
ATGGAACCTGGGACCCCGCTAGTT -> TGGAACCTGGGACCCCGCTAGTTT
TGGCGTTTGAGGGTATGGTTGCGC -> GGCGTTTGAGGGTATGGTTGCGCC
AGAAAACGCCCACTCCATCTCTAT -> GAAAACGCCCACTCCATCTCTATA
CGGTACCAGTTTAGCCTAAAGCAG -> GGTACCAGTTTAGCCTAAAGCAGG
AGTAGTGGTCTCGGAACGTGAAGA -> GTAGTGGTCTCGGAACGTGAAGAC
TCATTACTCTAACATCTACCGATA -> CATTACTCTAACATCTACCGATAT
CGGAGTATTCGGCTTACACACGCA -> GGAGTATTCGGCTTACACACGCAT
ATGCTGGAATCTTGACATTTTGTC -> TGCTGGAATCTTGACATTTTGTCT
GTCCGAAGGCCCAGATGTATACAA -> TCCGAAGGCCCAGATGTATACAAC
TGAGGTGACTGGATGGTCGGCACG -> GAGGTGACTGGATGGTCGGCACGA
GGACCGGAACCGAGAAGAATCGAT -> GACCGGAACCGAGAAGAATCGATT
CTTTTGAACAACCTTGTGCGGTCC -> TTTTGAACAACCTTGTGCGGTCCG
TCAAGTAACTGTGACAGGGTACAC -> CAAGTAACTGTGACAGGGTACACA
CGCTTACTGACATTTTGGTTATAG -> GCTTACTGACATTTTGGTTATAGG
CACTTTTGAACAACCTTGTGCGGT -> ACTTTTGAACAACCTTGTGCGGTC
TGCACTTGCATCTTGTCAGTAGCC -> GCACTTGCATCTTGTCAGTAGCCA
TTGTTTAGACCGGTAGTCCCAATT -> TGTTTAGACCGGTAGTCCCAATTA
CCTCGAATTTACAGCTCTGTATAT -> CTCGAATTTACAGCTCTGTATATG
GTGGCGTTTGAGGGTATGGTTGCG -> TGGCGTTTGAGGGTATGGTTGCGC
TTAGTACTCTAGGCCTTCACGTTT -> TAGTACTCTAGGCCTTCACGTTTT
GCCACCATCATTACTCTAACATCT -> CCACCATCATTACTCTAACATCTA
CCATCGATGCTTTAATAGTGGGTA -> CATCGATGCTTTAATAGTGGGTAT
TAACATGCCCAAAACGCTTATTCG -> AACATGCCCAAAACGCTTATTCGA
TGTGGAGCAAGGTCCTCACTTCGT -> GTGGAGCAAGGTCCTCACTTCGTC
TTATGAGTTTCCTTAATACCGCAC -> TATGAGTTTCCTTAATACCGCACG
TAGGAAATCTGAAGGCTCTTCTGC -> AGGAAATCTGAAGGCTCTTCTGCG
GGACGGCGAGGGGCGGCCCTAGTA -> GACGGCGAGGGGCGGCCCTAGTAC
CATAAGATGATTCATTGTTTCGTT -> ATAAGATGATTCATTGTTTCGTTG
GCGCTTTGCTCCACATCCAAGGTC -> CGCTTTGCTCCACATCCAAGGTCA
GACCGGAACCGAGAAGAATCGATT -> ACCGGAACCGAGAAGAATCGATTT
GTCCCGGCCGTCCTGGGACCGGAA -> TCCCGGCCGTCCTGGGACCGGAAC
GCTTATTCGACTCACCTAAGGCCA -> CTTATTCGACTCACCTAAGGCCAC
CCCACCAGTATACCCAAAGAATGT -> CCACCAGTATACCCAAAGAATGTG
AGTTGTCTGGGCGTTCATCCCCAT -> GTTGTCTGGGCGTTCATCCCCATG
ATCGCCGGTGACGCTACTTGGTGT -> TCGCCGGTGACGCTACTTGGTGTC
AGCTGGTCCACGATCCCAGATCGC -> GCTGGTCCACGATCCCAGATCGCG
TTTAGGAAATCTGAAGGCTCTTCT -> TTAGGAAATCTGAAGGCTCTTCTG
CACGAACTTAATATGAGGGTCATT -> ACGAACTTAATATGAGGGTCATTG
GTCATTGCCTGCTTTAGGAAATCT -> TCATTGCCTGCTTTAGGAAATCTG
TGAGACATATTCCCGGTGTCTAAG -> GAGACATATTCCCGGTGTCTAAGA
CGAGGGGCGGCCCTAGTACTTTCC -> GAGGGGCGGCCCTAGTACTTTCCC
GCAGCCCGCAGAACTGCGTAATGC -> CAGCCCGCAGAACTGCGTAATGCT
CATCATTACTCTAACATCTACCGA -> ATCATTACTCTAACATCTACCGAT
GCAAGTAGAGCCGGAGTTCGGTAA -> CAAGTAGAGCCGGAGTTCGGTAAT
ATCGCAACTTAAAGGCTTACGGTA -> TCGCAACTTAAAGGCTTACGGTAT
GAGTAACACAAAACGCGTCATGGC -> AGTAACACAAAACGCGTCATGGCG
CTGCTGATGGGTGAGAGTAGTGGT -> TGCTGATGGGTGAGAGTAGTGGTC
CGATCAGGCATATGCTGGAATCTT -> GATCAGGCATATGCTGGAATCTTG
ACTTGCCCAAAATGTCCCGGCCGT -> CTTGCCCAAAATGTCCCGGCCGTC
ACCCAAAGAATGTGCACTTGCATC -> CCCAAAGAATGTGCACTTGCATCT
CTTATCACCACCCTGCAAGTAGAG -> TTATCACCACCCTGCAAGTAGAGC
TAATCGCAACTTAAAGGCTTACGG -> AATCGCAACTTAAAGGCTTACGGT
GATCGCCGGTGACGCTACTTGGTG -> ATCGCCGGTGACGCTACTTGGTGT
GCTTTAGGAAATCTGAAGGCTCTT -> CTTTAGGAAATCTGAAGGCTCTTC
GTATGGTTGCGCCACCCCCACATG -> TATGGTTGCGCCACCCCCACATGT
TAGAGGGCAAATGGAACCTGGGAC -> AGAGGGCAAATGGAACCTGGGACC
TAAAGGCTTACGGTATACCAATCA -> AAAGGCTTACGGTATACCAATCAA
AAGTAACTGTGACAGGGTACACAC -> AGTAACTGTGACAGGGTACACACG
CCCTAGTACTTTCCCGAAAATAAA -> CCTAGTACTTTCCCGAAAATAAAC
GAGCCGGAGTTCGGTAATCTTAGT -> AGCCGGAGTTCGGTAATCTTAGTA
CCGCGCTGCTAGGAGCCCGAAGCG -> CGCGCTGCTAGGAGCCCGAAGCGG
GCACATTCTCACCTGCAGTAAATT -> CACATTCTCACCTGCAGTAAATTT
CTCCATCTCTATACCCTGTCATAC -> TCCATCTCTATACCCTGTCATACT
GAGAAGATGTCGACACATCCCTCA -> AGAAGATGTCGACACATCCCTCAA
TCGGTAATCTTAGTACTCTAGGCC -> CGGTAATCTTAGTACTCTAGGCCT
TTACTCTAACATCTACCGATATTT -> TACTCTAACATCTACCGATATTTG
TATACCAATCAACTATGTTGTGTA -> ATACCAATCAACTATGTTGTGTAG
ATAAGACGAAATCTAATGACTGTT -> TAAGACGAAATCTAATGACTGTTA
TGGCGACTTGCCCAAAATGTCCCG -> GGCGACTTGCCCAAAATGTCCCGG
ACGTGAAGACCGCACGTTGAGATA -> CGTGAAGACCGCACGTTGAGATAG
AAATCTAATGACTGTTACGAATGA -> AATCTAATGACTGTTACGAATGAG
TGGTCCACGATCCCAGATCGCGCT -> GGTCCACGATCCCAGATCGCGCTT
CCGGTGACGCTACTTGGTGTCCCT -> CGGTGACGCTACTTGGTGTCCCTC
GCCTTACAAGTCAGGTCATTGCCT -> CCTTACAAGTCAGGTCATTGCCTG
GAATCTTGACATTTTGTCTTGTCA -> AATCTTGACATTTTGTCTTGTCAC
GAGGGCAAATGGAACCTGGGACCC -> AGGGCAAATGGAACCTGGGACCCC
CTTAAATCTTTATGAGTTTCCTTA -> TTAAATCTTTATGAGTTTCCTTAA
GGTTATAGGACGTAAGGTGCCAGT -> GTTATAGGACGTAAGGTGCCAGTT
ATAGTGGGTATGGGGGCGATTGAC -> TAGTGGGTATGGGGGCGATTGACT
ACTATTTTCAGTGGCAGTACGGGG -> CTATTTTCAGTGGCAGTACGGGGC
GTAGGCCACACGTGACATGGACGG -> TAGGCCACACGTGACATGGACGGC
AAGAATCGATTTCATACTGAATCC -> AGAATCGATTTCATACTGAATCCA
TCTATACCCTGTCATACTTACCTT -> CTATACCCTGTCATACTTACCTTA
TACAGCTCTGTATATGTGCTAAAC -> ACAGCTCTGTATATGTGCTAAACT
GTCGGTAGGCCACACGTGACATGG -> TCGGTAGGCCACACGTGACATGGA
CATCTCTATACCCTGTCATACTTA -> ATCTCTATACCCTGTCATACTTAC
AACTGCGAGATTACGGTATGTGGG -> ACTGCGAGATTACGGTATGTGGGA
TCCATTAGGGCGCAATTTATGAGC -> CCATTAGGGCGCAATTTATGAGCA
AGGTCAAAGTGTGATCACTACTTC -> GGTCAAAGTGTGATCACTACTTCT
CTGGAAGGACACTTTTGAACAACC -> TGGAAGGACACTTTTGAACAACCT
GCCCACTCCATCTCTATACCCTGT -> CCCACTCCATCTCTATACCCTGTC
CTGCTAGGAGCCCGAAGCGGTTGA -> TGCTAGGAGCCCGAAGCGGTTGAC
CCTGGGACCGGAACCGAGAAGAAT -> CTGGGACCGGAACCGAGAAGAATC
GGCTTACACACGCATGTAGTACCT -> GCTTACACACGCATGTAGTACCTG
TTGGTGTCCCTCGAATTTACAGCT -> TGGTGTCCCTCGAATTTACAGCTC
AACTATGTTGTGTAGACGTAGAGA -> ACTATGTTGTGTAGACGTAGAGAT
CTTGTGCGGTCCGAAGGCCCAGAT -> TTGTGCGGTCCGAAGGCCCAGATG
GGTCCTCACTTCGTCCTGTAGAGG -> GTCCTCACTTCGTCCTGTAGAGGG
CTGAAGGCTCTTCTGCGCGGTACC -> TGAAGGCTCTTCTGCGCGGTACCA
AAGGCTTACGGTATACCAATCAAC -> AGGCTTACGGTATACCAATCAACT
ATTCCTTCGGAGTATTCGGCTTAC -> TTCCTTCGGAGTATTCGGCTTACA
ATTACTCTAACATCTACCGATATT -> TTACTCTAACATCTACCGATATTT
ACGAAATCTAATGACTGTTACGAA -> CGAAATCTAATGACTGTTACGAAT
TAGCTTAAACAGATTTCGGAACAT -> AGCTTAAACAGATTTCGGAACATA
CGGCCGTCCTGGGACCGGAACCGA -> GGCCGTCCTGGGACCGGAACCGAG
TTTCCCGCGTAATATTCATTTAAC -> TTCCCGCGTAATATTCATTTAACA
TCAAACCCACCAGTATACCCAAAG -> CAAACCCACCAGTATACCCAAAGA
GTTTAGCCGCGGAGAAGATGTCGA -> TTTAGCCGCGGAGAAGATGTCGAC
ACAAAACGCGTCATGGCGACTTGC -> CAAAACGCGTCATGGCGACTTGCC
TTGTGTAGACGTAGAGATTGGATC -> TGTGTAGACGTAGAGATTGGATCG
GTATTCGGCTTACACACGCATGTA -> TATTCGGCTTACACACGCATGTAG
GCGCTGCTAGGAGCCCGAAGCGGT -> CGCTGCTAGGAGCCCGAAGCGGTT
CCCTGTCATACTTACCTTAAATCT -> CCTGTCATACTTACCTTAAATCTT
TAGCACCTGATCCTCTTCCATAAG -> AGCACCTGATCCTCTTCCATAAGA
GTGCCTTGTACAAGTATCAGCGCC -> TGCCTTGTACAAGTATCAGCGCCA
CTCTTCTGCGCGGTACCAGTTTAG -> TCTTCTGCGCGGTACCAGTTTAGC
GTCTCGGAACGTGAAGACCGCACG -> TCTCGGAACGTGAAGACCGCACGT
GGCTCACTCCTCCGTCTGGAAGGA -> GCTCACTCCTCCGTCTGGAAGGAC
TGATTCATTGTTTCGTTGCCCCCG -> GATTCATTGTTTCGTTGCCCCCGT
ATGTATACAACGCTTATAAACTTA -> TGTATACAACGCTTATAAACTTAT
TTTCAAATAAGACGAAATCTAATG -> TTCAAATAAGACGAAATCTAATGA
ACTCACCTAAGGCCACCATCATTA -> CTCACCTAAGGCCACCATCATTAC
CGATGCTTTAATAGTGGGTATGGG -> GATGCTTTAATAGTGGGTATGGGG
CGTCATGGCGACTTGCCCAAAATG -> GTCATGGCGACTTGCCCAAAATGT
CGAATACATCAATCGTCGCCGCAG -> GAATACATCAATCGTCGCCGCAGC
TACAACGCTTATAAACTTATCACC -> ACAACGCTTATAAACTTATCACCA
CATTCCGAAGTACACTTAGTATCC -> ATTCCGAAGTACACTTAGTATCCA
TGCTGATGGGTGAGAGTAGTGGTC -> GCTGATGGGTGAGAGTAGTGGTCT
GGTGACTGGATGGTCGGCACGAAC -> GTGACTGGATGGTCGGCACGAACT
TCGGAACATATAACAATGAGGATA -> CGGAACATATAACAATGAGGATAC
CTTACACACGCATGTAGTACCTGG -> TTACACACGCATGTAGTACCTGGC
CCCGGCCGTCCTGGGACCGGAACC -> CCGGCCGTCCTGGGACCGGAACCG
TCCCAGATCGCGCTTACTGACATT -> CCCAGATCGCGCTTACTGACATTT
TGTCAGTAGCCATACTCCAATGCC -> GTCAGTAGCCATACTCCAATGCCG
GATAATCGCAACTTAAAGGCTTAC -> ATAATCGCAACTTAAAGGCTTACG
TCTAATGACTGTTACGAATGAGAC -> CTAATGACTGTTACGAATGAGACA
GGACACTTTTGAACAACCTTGTGC -> GACACTTTTGAACAACCTTGTGCG
AATACCGCACGATCAGGCATATGC -> ATACCGCACGATCAGGCATATGCT
TTCCCGAAAATAAACCTTCCGGTC -> TCCCGAAAATAAACCTTCCGGTCG
ACTGACATTTTGGTTATAGGACGT -> CTGACATTTTGGTTATAGGACGTA
CCCGGTGTCTAAGATAATCGCAAC -> CCGGTGTCTAAGATAATCGCAACT
TAAGGCCTTACAAGTCAGGTCATT -> AAGGCCTTACAAGTCAGGTCATTG
TAAGGCCACCATCATTACTCTAAC -> AAGGCCACCATCATTACTCTAACA
GGTCAAATACTTTCGAATACATCA -> GTCAAATACTTTCGAATACATCAA
GTAGAGCCGGAGTTCGGTAATCTT -> TAGAGCCGGAGTTCGGTAATCTTA
TGTCCCGGCCGTCCTGGGACCGGA -> GTCCCGGCCGTCCTGGGACCGGAA
CACGATCCCAGATCGCGCTTACTG -> ACGATCCCAGATCGCGCTTACTGA
TATATGTGCTAAACTGCGAGATTA -> ATATGTGCTAAACTGCGAGATTAC
CCGCAGAACCCGCGCTGCTAGGAG -> CGCAGAACCCGCGCTGCTAGGAGC
CCCTGACAAATGCCGTTTCGCTTG -> CCTGACAAATGCCGTTTCGCTTGA
AACCTTCCGGTCGCTGCGCTTTGC -> ACCTTCCGGTCGCTGCGCTTTGCT
TGACAAAACGTGACATAGCTTAAA -> GACAAAACGTGACATAGCTTAAAC
ACCCGCGCTGCTAGGAGCCCGAAG -> CCCGCGCTGCTAGGAGCCCGAAGC
AGCGGTTGACAAAACGTGACATAG -> GCGGTTGACAAAACGTGACATAGC
GTAATGCTCGTAGCAATATCTACG -> TAATGCTCGTAGCAATATCTACGG
TGTGACAGGGTACACACGTAATCC -> GTGACAGGGTACACACGTAATCCG
CTTGTCAGTAGCCATACTCCAATG -> TTGTCAGTAGCCATACTCCAATGC
TTCAGTGGCAGTACGGGGCTCACT -> TCAGTGGCAGTACGGGGCTCACTC
GTAGTGGTCTCGGAACGTGAAGAC -> TAGTGGTCTCGGAACGTGAAGACC
AATATTCATTTAACATGCCCAAAA -> ATATTCATTTAACATGCCCAAAAC
TCGTTGCCCCCGTCTTCGGGTAGG -> CGTTGCCCCCGTCTTCGGGTAGGT
AACCTTGTGCGGTCCGAAGGCCCA -> ACCTTGTGCGGTCCGAAGGCCCAG
CCTAAAGCAGGACTTATCAAACCC -> CTAAAGCAGGACTTATCAAACCCA
ACGCTACTTGGTGTCCCTCGAATT -> CGCTACTTGGTGTCCCTCGAATTT
AACCCACCAGTATACCCAAAGAAT -> ACCCACCAGTATACCCAAAGAATG
CCATACTCCAATGCCGAGTTGTCT -> CATACTCCAATGCCGAGTTGTCTG
AAATGGAACCTGGGACCCCGCTAG -> AATGGAACCTGGGACCCCGCTAGT
ACAAATGCCGTTTCGCTTGATATC -> CAAATGCCGTTTCGCTTGATATCA
ATGAGCACGGGTCAAATACTTTCG -> TGAGCACGGGTCAAATACTTTCGA
GACCAGTCTCTCCCTGGATCGAGA -> ACCAGTCTCTCCCTGGATCGAGAA
GTGCCAGTTTCCCGCGTAATATTC -> TGCCAGTTTCCCGCGTAATATTCA
CCCGGCTAACTATTTTCAGTGGCA -> CCGGCTAACTATTTTCAGTGGCAG
ACATCAATCGTCGCCGCAGCGAAC -> CATCAATCGTCGCCGCAGCGAACT
TCTTTATGAGTTTCCTTAATACCG -> CTTTATGAGTTTCCTTAATACCGC
CTGGAATCTTGACATTTTGTCTTG -> TGGAATCTTGACATTTTGTCTTGT
TAACATCTACCGATATTTGTGGAG -> AACATCTACCGATATTTGTGGAGC
GCCCAGATGTATACAACGCTTATA -> CCCAGATGTATACAACGCTTATAA
GGGCGTTCATCCCCATGCTCGTGG -> GGCGTTCATCCCCATGCTCGTGGT
CTACGGTACAAGTCGGTAGGCCAC -> TACGGTACAAGTCGGTAGGCCACA
TCACAGCGTGGCGTTTGAGGGTAT -> CACAGCGTGGCGTTTGAGGGTATG
TATCGCCTCCTTTGTCTCGTCATT -> ATCGCCTCCTTTGTCTCGTCATTC
TATTCGACTCACCTAAGGCCACCA -> ATTCGACTCACCTAAGGCCACCAT
TATCAGCGCCATCGATGCTTTAAT -> ATCAGCGCCATCGATGCTTTAATA
GGGAGCAGCCCGCAGAACTGCGTA -> GGAGCAGCCCGCAGAACTGCGTAA
AGTCAGGTCATTGCCTGCTTTAGG -> GTCAGGTCATTGCCTGCTTTAGGA
TCTTCTTCAAACAATTCCTTCGGA -> CTTCTTCAAACAATTCCTTCGGAG
ATCCAAGGTCAAAGTGTGATCACT -> TCCAAGGTCAAAGTGTGATCACTA
CCCGCAGAACTGCGTAATGCTCGT -> CCGCAGAACTGCGTAATGCTCGTA
GTCCTCACTTCGTCCTGTAGAGGG -> TCCTCACTTCGTCCTGTAGAGGGC
TGGTCGGCACGAACTTAATATGAG -> GGTCGGCACGAACTTAATATGAGG
GCTTATAAACTTATCACCACCCTG -> CTTATAAACTTATCACCACCCTGC
CAGTACGGGGCTCACTCCTCCGTC -> AGTACGGGGCTCACTCCTCCGTCT
AACGCGTCATGGCGACTTGCCCAA -> ACGCGTCATGGCGACTTGCCCAAA
TGTGTAGACGTAGAGATTGGATCG -> GTGTAGACGTAGAGATTGGATCGC
CAGCCCGCAGAACTGCGTAATGCT -> AGCCCGCAGAACTGCGTAATGCTC
CGCTGCTAGGAGCCCGAAGCGGTT -> GCTGCTAGGAGCCCGAAGCGGTTG
CCTGCTTTAGGAAATCTGAAGGCT -> CTGCTTTAGGAAATCTGAAGGCTC
CCGAGAAGAATCGATTTCATACTG -> CGAGAAGAATCGATTTCATACTGA
TATAGGACGTAAGGTGCCAGTTTC -> ATAGGACGTAAGGTGCCAGTTTCC
CGGTAGTCCCAATTACTGGAGTAA -> GGTAGTCCCAATTACTGGAGTAAC
GAGATTGGATCGCCGGTGACGCTA -> AGATTGGATCGCCGGTGACGCTAC
TTAGGGGCTGAGGTGACTGGATGG -> TAGGGGCTGAGGTGACTGGATGGT
TTGACATTTTGTCTTGTCACAGCG -> TGACATTTTGTCTTGTCACAGCGT
TACCAGTTTAGCCTAAAGCAGGAC -> ACCAGTTTAGCCTAAAGCAGGACT
AGGACGTAAGGTGCCAGTTTCCCG -> GGACGTAAGGTGCCAGTTTCCCGC
TTCTCACCTGCAGTAAATTTAGGG -> TCTCACCTGCAGTAAATTTAGGGG
GACATATTCCCGGTGTCTAAGATA -> ACATATTCCCGGTGTCTAAGATAA
ATTGCCTGCTTTAGGAAATCTGAA -> TTGCCTGCTTTAGGAAATCTGAAG
TTCCATAAGATGATTCATTGTTTC -> TCCATAAGATGATTCATTGTTTCG
GGACTTATCAAACCCACCAGTATA -> GACTTATCAAACCCACCAGTATAC
CTTATAAACTTATCACCACCCTGC -> TTATAAACTTATCACCACCCTGCA
GACATTAGAAAACGCCCACTCCAT -> ACATTAGAAAACGCCCACTCCATC
AGGCCCAGATGTATACAACGCTTA -> GGCCCAGATGTATACAACGCTTAT
GACACATCCCTCAAGTAACTGTGA -> ACACATCCCTCAAGTAACTGTGAC
CGTCTGGAAGGACACTTTTGAACA -> GTCTGGAAGGACACTTTTGAACAA
AATTTACAGCTCTGTATATGTGCT -> ATTTACAGCTCTGTATATGTGCTA
CTTCCATAAGATGATTCATTGTTT -> TTCCATAAGATGATTCATTGTTTC
TCTCGTCATTCCGAAGTACACTTA -> CTCGTCATTCCGAAGTACACTTAG
TCAATCGTCGCCGCAGCGAACTCG -> CAATCGTCGCCGCAGCGAACTCGT
CTTTGCTCCACATCCAAGGTCAAA -> TTTGCTCCACATCCAAGGTCAAAG
GTACACTTAGTATCCAGTTTCAAA -> TACACTTAGTATCCAGTTTCAAAT
AGGTGCCAGTTTCCCGCGTAATAT -> GGTGCCAGTTTCCCGCGTAATATT
TGCGTAATGCTCGTAGCAATATCT -> GCGTAATGCTCGTAGCAATATCTA
GGAGTAACACAAAACGCGTCATGG -> GAGTAACACAAAACGCGTCATGGC
AAGCAGGACTTATCAAACCCACCA -> AGCAGGACTTATCAAACCCACCAG
AATGAGGATACACCTTGTTATCGC -> ATGAGGATACACCTTGTTATCGCC
GGCGACTTGCCCAAAATGTCCCGG -> GCGACTTGCCCAAAATGTCCCGGC
CTCTATACCCTGTCATACTTACCT -> TCTATACCCTGTCATACTTACCTT
GATCCTCTTCCATAAGATGATTCA -> ATCCTCTTCCATAAGATGATTCAT
TGTGCACTTGCATCTTGTCAGTAG -> GTGCACTTGCATCTTGTCAGTAGC
AGTGGTCTCGGAACGTGAAGACCG -> GTGGTCTCGGAACGTGAAGACCGC
ACCTGATCCTCTTCCATAAGATGA -> CCTGATCCTCTTCCATAAGATGAT
GCGTAATATTCATTTAACATGCCC -> CGTAATATTCATTTAACATGCCCA
GTTTCCTTAATACCGCACGATCAG -> TTTCCTTAATACCGCACGATCAGG
TCTAACATCTACCGATATTTGTGG -> CTAACATCTACCGATATTTGTGGA
AACGTGAAGACCGCACGTTGAGAT -> ACGTGAAGACCGCACGTTGAGATA
GCCGTCCTGGGACCGGAACCGAGA -> CCGTCCTGGGACCGGAACCGAGAA
AGTATCAGCGCCATCGATGCTTTA -> GTATCAGCGCCATCGATGCTTTAA
TTCGGGTAGGTATCTTCTTCAAAC -> TCGGGTAGGTATCTTCTTCAAACA
TCACCTGCAGTAAATTTAGGGGCT -> CACCTGCAGTAAATTTAGGGGCTG
CGAAGTACACTTAGTATCCAGTTT -> GAAGTACACTTAGTATCCAGTTTC
TGACAGGGTACACACGTAATCCGC -> GACAGGGTACACACGTAATCCGCA
TCGCCGGTGACGCTACTTGGTGTC -> CGCCGGTGACGCTACTTGGTGTCC
CACCTGCAGTAAATTTAGGGGCTG -> ACCTGCAGTAAATTTAGGGGCTGA
TATGAGCACGGGTCAAATACTTTC -> ATGAGCACGGGTCAAATACTTTCG
ACGTGACATAGCTTAAACAGATTT -> CGTGACATAGCTTAAACAGATTTC
ATCCCAGATCGCGCTTACTGACAT -> TCCCAGATCGCGCTTACTGACATT
CGCCTCCTTTGTCTCGTCATTCCG -> GCCTCCTTTGTCTCGTCATTCCGA
TAGGAGCCCGAAGCGGTTGACAAA -> AGGAGCCCGAAGCGGTTGACAAAA
GCTAAACTGCGAGATTACGGTATG -> CTAAACTGCGAGATTACGGTATGT
TGCGCTTTGCTCCACATCCAAGGT -> GCGCTTTGCTCCACATCCAAGGTC
AACAATTCCTTCGGAGTATTCGGC -> ACAATTCCTTCGGAGTATTCGGCT
GGCGCAATTTATGAGCACGGGTCA -> GCGCAATTTATGAGCACGGGTCAA
TTTTGGTTATAGGACGTAAGGTGC -> TTTGGTTATAGGACGTAAGGTGCC
ACCGATATTTGTGGAGCAAGGTCC -> CCGATATTTGTGGAGCAAGGTCCT
CCCCACATGTTCCCTGACAAATGC -> CCCACATGTTCCCTGACAAATGCC
CGAAGCGGTTGACAAAACGTGACA -> GAAGCGGTTGACAAAACGTGACAT
ACTTATCACCACCCTGCAAGTAGA -> CTTATCACCACCCTGCAAGTAGAG
GCTCGTAGCAATATCTACGGTACA -> CTCGTAGCAATATCTACGGTACAA
CTATGTTGTGTAGACGTAGAGATT -> TATGTTGTGTAGACGTAGAGATTG
TTCAAATAAGACGAAATCTAATGA -> TCAAATAAGACGAAATCTAATGAC
AGCTTAAACAGATTTCGGAACATA -> GCTTAAACAGATTTCGGAACATAT
GACGCTACTTGGTGTCCCTCGAAT -> ACGCTACTTGGTGTCCCTCGAATT
CGGCTAACTATTTTCAGTGGCAGT -> GGCTAACTATTTTCAGTGGCAGTA
TTAGACCGGTAGTCCCAATTACTG -> TAGACCGGTAGTCCCAATTACTGG
GAGATAGCACCTGATCCTCTTCCA -> AGATAGCACCTGATCCTCTTCCAT
GAACTTAATATGAGGGTCATTGTT -> AACTTAATATGAGGGTCATTGTTA
AAAACGCCCACTCCATCTCTATAC -> AAACGCCCACTCCATCTCTATACC
TCTTCAAACAATTCCTTCGGAGTA -> CTTCAAACAATTCCTTCGGAGTAT
TAAACTGCGAGATTACGGTATGTG -> AAACTGCGAGATTACGGTATGTGG
ACATAGCTTAAACAGATTTCGGAA -> CATAGCTTAAACAGATTTCGGAAC
CACATCCCTCAAGTAACTGTGACA -> ACATCCCTCAAGTAACTGTGACAG
GGCTTACGGTATACCAATCAACTA -> GCTTACGGTATACCAATCAACTAT
CGGCTTACACACGCATGTAGTACC -> GGCTTACACACGCATGTAGTACCT
GAATGTGCACTTGCATCTTGTCAG -> AATGTGCACTTGCATCTTGTCAGT
CAAATGCCGTTTCGCTTGATATCA -> AAATGCCGTTTCGCTTGATATCAG
TTCATTTAACATGCCCAAAACGCT -> TCATTTAACATGCCCAAAACGCTT
GCAGTACGGGGCTCACTCCTCCGT -> CAGTACGGGGCTCACTCCTCCGTC
TGCTGGAATCTTGACATTTTGTCT -> GCTGGAATCTTGACATTTTGTCTT
TATCCAGTTTCAAATAAGACGAAA -> ATCCAGTTTCAAATAAGACGAAAT
CGCTTATAAACTTATCACCACCCT -> GCTTATAAACTTATCACCACCCTG
ATTGGATTTAAGGCCTTACAAGTC -> TTGGATTTAAGGCCTTACAAGTCA
ATATCTACGGTACAAGTCGGTAGG -> TATCTACGGTACAAGTCGGTAGGC
GTCGCTGCGCTTTGCTCCACATCC -> TCGCTGCGCTTTGCTCCACATCCA
GTGGAGCAAGGTCCTCACTTCGTC -> TGGAGCAAGGTCCTCACTTCGTCC
ATCCCCATGCTCGTGGTGCCTTGT -> TCCCCATGCTCGTGGTGCCTTGTA
ATTTTGTCTTGTCACAGCGTGGCG -> TTTTGTCTTGTCACAGCGTGGCGT
GTCATTGTTAGGTGTTTAGCCGCG -> TCATTGTTAGGTGTTTAGCCGCGG
TTAGCCGCGGAGAAGATGTCGACA -> TAGCCGCGGAGAAGATGTCGACAC
CCAGTCTCTCCCTGGATCGAGAAG -> CAGTCTCTCCCTGGATCGAGAAGC
CCTGGATCGAGAAGCTGCTGATGG -> CTGGATCGAGAAGCTGCTGATGGG
GTGGGAGCAGCCCGCAGAACTGCG -> TGGGAGCAGCCCGCAGAACTGCGT
ATAGGACGTAAGGTGCCAGTTTCC -> TAGGACGTAAGGTGCCAGTTTCCC
AAGTCGGTAGGCCACACGTGACAT -> AGTCGGTAGGCCACACGTGACATG
CCGTCTGGAAGGACACTTTTGAAC -> CGTCTGGAAGGACACTTTTGAACA
TTCCCGCGTAATATTCATTTAACA -> TCCCGCGTAATATTCATTTAACAT
GAAGCTGCTGATGGGTGAGAGTAG -> AAGCTGCTGATGGGTGAGAGTAGT
CATTTTGTCTTGTCACAGCGTGGC -> ATTTTGTCTTGTCACAGCGTGGCG
ATCGATTTCATACTGAATCCATTA -> TCGATTTCATACTGAATCCATTAG
GACTTATCAAACCCACCAGTATAC -> ACTTATCAAACCCACCAGTATACC
ACGGGGCTCACTCCTCCGTCTGGA -> CGGGGCTCACTCCTCCGTCTGGAA
CCACTCCATCTCTATACCCTGTCA -> CACTCCATCTCTATACCCTGTCAT
TAACTGTGACAGGGTACACACGTA -> AACTGTGACAGGGTACACACGTAA
TTTCGAATACATCAATCGTCGCCG -> TTCGAATACATCAATCGTCGCCGC
TAACTATTTTCAGTGGCAGTACGG -> AACTATTTTCAGTGGCAGTACGGG
GCAATATCTACGGTACAAGTCGGT -> CAATATCTACGGTACAAGTCGGTA
ACAGCGTGGCGTTTGAGGGTATGG -> CAGCGTGGCGTTTGAGGGTATGGT
TAATGCTCGTAGCAATATCTACGG -> AATGCTCGTAGCAATATCTACGGT
AAGCTGCTGATGGGTGAGAGTAGT -> AGCTGCTGATGGGTGAGAGTAGTG
CGTCATTCCGAAGTACACTTAGTA -> GTCATTCCGAAGTACACTTAGTAT
GTACCTGGCACCATTGGATTTAAG -> TACCTGGCACCATTGGATTTAAGG
GGTATGGTTGCGCCACCCCCACAT -> GTATGGTTGCGCCACCCCCACATG
CCTTTGTCTCGTCATTCCGAAGTA -> CTTTGTCTCGTCATTCCGAAGTAC
ACAACCTTGTGCGGTCCGAAGGCC -> CAACCTTGTGCGGTCCGAAGGCCC
TATACCCAAAGAATGTGCACTTGC -> ATACCCAAAGAATGTGCACTTGCA
TGTCTAAGATAATCGCAACTTAAA -> GTCTAAGATAATCGCAACTTAAAG
ACACTTTTGAACAACCTTGTGCGG -> CACTTTTGAACAACCTTGTGCGGT
GTCCTGTAGAGGGCAAATGGAACC -> TCCTGTAGAGGGCAAATGGAACCT
GTTTGAGGGTATGGTTGCGCCACC -> TTTGAGGGTATGGTTGCGCCACCC
TCAAATACTTTCGAATACATCAAT -> CAAATACTTTCGAATACATCAATC
GGCTCTTCTGCGCGGTACCAGTTT -> GCTCTTCTGCGCGGTACCAGTTTA
CACGTTTTGTTTAGACCGGTAGTC -> ACGTTTTGTTTAGACCGGTAGTCC
ATGTCCCGGCCGTCCTGGGACCGG -> TGTCCCGGCCGTCCTGGGACCGGA
GGATACACCTTGTTATCGCCTCCT -> GATACACCTTGTTATCGCCTCCTT
CTGTTACGAATGAGACATATTCCC -> TGTTACGAATGAGACATATTCCCG
ACACACGCATGTAGTACCTGGCAC -> CACACGCATGTAGTACCTGGCACC
CTACTTGGTGTCCCTCGAATTTAC -> TACTTGGTGTCCCTCGAATTTACA
CTCGTGCACATTCTCACCTGCAGT -> TCGTGCACATTCTCACCTGCAGTA
GCCACACGTGACATGGACGGCGAG -> CCACACGTGACATGGACGGCGAGG
ATCGAGAAGCTGCTGATGGGTGAG -> TCGAGAAGCTGCTGATGGGTGAGA
GCTCCACATCCAAGGTCAAAGTGT -> CTCCACATCCAAGGTCAAAGTGTG
ATTTACAGCTCTGTATATGTGCTA -> TTTACAGCTCTGTATATGTGCTAA
CCACATGTTCCCTGACAAATGCCG -> CACATGTTCCCTGACAAATGCCGT
TATGTGGGAGCAGCCCGCAGAACT -> ATGTGGGAGCAGCCCGCAGAACTG
TAAACAGATTTCGGAACATATAAC -> AAACAGATTTCGGAACATATAACA
CAGGCATATGCTGGAATCTTGACA -> AGGCATATGCTGGAATCTTGACAT
AACGCCCACTCCATCTCTATACCC -> ACGCCCACTCCATCTCTATACCCT
AAACTTATCACCACCCTGCAAGTA -> AACTTATCACCACCCTGCAAGTAG
CGCAGCGAACTCGTGCACATTCTC -> GCAGCGAACTCGTGCACATTCTCA
ACCATTGGATTTAAGGCCTTACAA -> CCATTGGATTTAAGGCCTTACAAG
TCACTTCGTCCTGTAGAGGGCAAA -> CACTTCGTCCTGTAGAGGGCAAAT
GACATTTTGGTTATAGGACGTAAG -> ACATTTTGGTTATAGGACGTAAGG
GGAACCTGGGACCCCGCTAGTTTG -> GAACCTGGGACCCCGCTAGTTTGA
GTTTAGCCTAAAGCAGGACTTATC -> TTTAGCCTAAAGCAGGACTTATCA
AGGGTACACACGTAATCCGCAGAA -> GGGTACACACGTAATCCGCAGAAC
CGGAACCGAGAAGAATCGATTTCA -> GGAACCGAGAAGAATCGATTTCAT
GATGGTCGGCACGAACTTAATATG -> ATGGTCGGCACGAACTTAATATGA
AATTCCTTCGGAGTATTCGGCTTA -> ATTCCTTCGGAGTATTCGGCTTAC
GAGATTACGGTATGTGGGAGCAGC -> AGATTACGGTATGTGGGAGCAGCC
CGTAGCAATATCTACGGTACAAGT -> GTAGCAATATCTACGGTACAAGTC
CCTTAAATCTTTATGAGTTTCCTT -> CTTAAATCTTTATGAGTTTCCTTA
GGAGCAGCCCGCAGAACTGCGTAA -> GAGCAGCCCGCAGAACTGCGTAAT
ATCACCACCCTGCAAGTAGAGCCG -> TCACCACCCTGCAAGTAGAGCCGG
AGTATCCAGTTTCAAATAAGACGA -> GTATCCAGTTTCAAATAAGACGAA
AGGCCTTACAAGTCAGGTCATTGC -> GGCCTTACAAGTCAGGTCATTGCC
ACTTTTGAACAACCTTGTGCGGTC -> CTTTTGAACAACCTTGTGCGGTCC
ATTAGAAAACGCCCACTCCATCTC -> TTAGAAAACGCCCACTCCATCTCT
ACGTTTTGTTTAGACCGGTAGTCC -> CGTTTTGTTTAGACCGGTAGTCCC
GTGGTCTCGGAACGTGAAGACCGC -> TGGTCTCGGAACGTGAAGACCGCA
TTGTCTGGGCGTTCATCCCCATGC -> TGTCTGGGCGTTCATCCCCATGCT
TGGATGGTCGGCACGAACTTAATA -> GGATGGTCGGCACGAACTTAATAT
ACTGCGAGATTACGGTATGTGGGA -> CTGCGAGATTACGGTATGTGGGAG
CGGAGTTCGGTAATCTTAGTACTC -> GGAGTTCGGTAATCTTAGTACTCT
TCTTCTGCGCGGTACCAGTTTAGC -> CTTCTGCGCGGTACCAGTTTAGCC
CATCCAAGGTCAAAGTGTGATCAC -> ATCCAAGGTCAAAGTGTGATCACT
AGCACCTGATCCTCTTCCATAAGA -> GCACCTGATCCTCTTCCATAAGAT
AGACGAAATCTAATGACTGTTACG -> GACGAAATCTAATGACTGTTACGA
GCTGCTAGGAGCCCGAAGCGGTTG -> CTGCTAGGAGCCCGAAGCGGTTGA
AGTAACTGTGACAGGGTACACACG -> GTAACTGTGACAGGGTACACACGT
ACACATCCCTCAAGTAACTGTGAC -> CACATCCCTCAAGTAACTGTGACA
CACCATCATTACTCTAACATCTAC -> ACCATCATTACTCTAACATCTACC
CGCAACTTAAAGGCTTACGGTATA -> GCAACTTAAAGGCTTACGGTATAC
AGGTGTTTAGCCGCGGAGAAGATG -> GGTGTTTAGCCGCGGAGAAGATGT
CACCTAAGGCCACCATCATTACTC -> ACCTAAGGCCACCATCATTACTCT
AAATCTTTATGAGTTTCCTTAATA -> AATCTTTATGAGTTTCCTTAATAC
TGCAAGTAGAGCCGGAGTTCGGTA -> GCAAGTAGAGCCGGAGTTCGGTAA
GGGTATGGTTGCGCCACCCCCACA -> GGTATGGTTGCGCCACCCCCACAT
ATGAGACATATTCCCGGTGTCTAA -> TGAGACATATTCCCGGTGTCTAAG
TTACAAGTCAGGTCATTGCCTGCT -> TACAAGTCAGGTCATTGCCTGCTT
TCCCGGTGTCTAAGATAATCGCAA -> CCCGGTGTCTAAGATAATCGCAAC
CCCAAAATGTCCCGGCCGTCCTGG -> CCAAAATGTCCCGGCCGTCCTGGG
ACCAGTATACCCAAAGAATGTGCA -> CCAGTATACCCAAAGAATGTGCAC
TCGAATTTACAGCTCTGTATATGT -> CGAATTTACAGCTCTGTATATGTG
TGAACAACCTTGTGCGGTCCGAAG -> GAACAACCTTGTGCGGTCCGAAGG
TCCCGCGTAATATTCATTTAACAT -> CCCGCGTAATATTCATTTAACATG
CATTACTCTAACATCTACCGATAT -> ATTACTCTAACATCTACCGATATT
TTTAGCCGCGGAGAAGATGTCGAC -> TTAGCCGCGGAGAAGATGTCGACA
ACAGATTTCGGAACATATAACAAT -> CAGATTTCGGAACATATAACAATG
ACATTAGAAAACGCCCACTCCATC -> CATTAGAAAACGCCCACTCCATCT
CATATGCTGGAATCTTGACATTTT -> ATATGCTGGAATCTTGACATTTTG
ATGCTCGTAGCAATATCTACGGTA -> TGCTCGTAGCAATATCTACGGTAC
AGACATATTCCCGGTGTCTAAGAT -> GACATATTCCCGGTGTCTAAGATA
AGCCTAAAGCAGGACTTATCAAAC -> GCCTAAAGCAGGACTTATCAAACC
GTCGACACATCCCTCAAGTAACTG -> TCGACACATCCCTCAAGTAACTGT
TAGGTATCTTCTTCAAACAATTCC -> AGGTATCTTCTTCAAACAATTCCT
TGTGCTAAACTGCGAGATTACGGT -> GTGCTAAACTGCGAGATTACGGTA
GTTTTGTTTAGACCGGTAGTCCCA -> TTTTGTTTAGACCGGTAGTCCCAA
CAAACAATTCCTTCGGAGTATTCG -> AAACAATTCCTTCGGAGTATTCGG
CAGACATTAGAAAACGCCCACTCC -> AGACATTAGAAAACGCCCACTCCA
GTCCCTCGAATTTACAGCTCTGTA -> TCCCTCGAATTTACAGCTCTGTAT
GACGTAAGGTGCCAGTTTCCCGCG -> ACGTAAGGTGCCAGTTTCCCGCGT
TGGAATCTTGACATTTTGTCTTGT -> GGAATCTTGACATTTTGTCTTGTC
TAATATTCATTTAACATGCCCAAA -> AATATTCATTTAACATGCCCAAAA
TCACGTTTTGTTTAGACCGGTAGT -> CACGTTTTGTTTAGACCGGTAGTC
TCGGAGTATTCGGCTTACACACGC -> CGGAGTATTCGGCTTACACACGCA
ATGGTTGCGCCACCCCCACATGTT -> TGGTTGCGCCACCCCCACATGTTC
ATTCGGCTTACACACGCATGTAGT -> TTCGGCTTACACACGCATGTAGTA
AACTATTTTCAGTGGCAGTACGGG -> ACTATTTTCAGTGGCAGTACGGGG
TAGACCGGTAGTCCCAATTACTGG -> AGACCGGTAGTCCCAATTACTGGA
TAATACCGCACGATCAGGCATATG -> AATACCGCACGATCAGGCATATGC
GGAGTTCGGTAATCTTAGTACTCT -> GAGTTCGGTAATCTTAGTACTCTA
CGGTCGCTGCGCTTTGCTCCACAT -> GGTCGCTGCGCTTTGCTCCACATC
CGTCTTCGGGTAGGTATCTTCTTC -> GTCTTCGGGTAGGTATCTTCTTCA
TGTAGTACCTGGCACCATTGGATT -> GTAGTACCTGGCACCATTGGATTT
GGCAAATGGAACCTGGGACCCCGC -> GCAAATGGAACCTGGGACCCCGCT
GGTCTCGGAACGTGAAGACCGCAC -> GTCTCGGAACGTGAAGACCGCACG
ACAATGAGGATACACCTTGTTATC -> CAATGAGGATACACCTTGTTATCG
CTTGCCCAAAATGTCCCGGCCGTC -> TTGCCCAAAATGTCCCGGCCGTCC
AATAGTGGGTATGGGGGCGATTGA -> ATAGTGGGTATGGGGGCGATTGAC
ACATCCAAGGTCAAAGTGTGATCA -> CATCCAAGGTCAAAGTGTGATCAC
ATCTTCTTCAAACAATTCCTTCGG -> TCTTCTTCAAACAATTCCTTCGGA
AGTTTAGCCTAAAGCAGGACTTAT -> GTTTAGCCTAAAGCAGGACTTATC
GAACCCGCGCTGCTAGGAGCCCGA -> AACCCGCGCTGCTAGGAGCCCGAA
TCGGAACGTGAAGACCGCACGTTG -> CGGAACGTGAAGACCGCACGTTGA
CTGTAGAGGGCAAATGGAACCTGG -> TGTAGAGGGCAAATGGAACCTGGG
ATTTAAGGCCTTACAAGTCAGGTC -> TTTAAGGCCTTACAAGTCAGGTCA
ACGATCAGGCATATGCTGGAATCT -> CGATCAGGCATATGCTGGAATCTT
CGCAGAACCCGCGCTGCTAGGAGC -> GCAGAACCCGCGCTGCTAGGAGCC
AGACCGGTAGTCCCAATTACTGGA -> GACCGGTAGTCCCAATTACTGGAG
TCCCTGGATCGAGAAGCTGCTGAT -> CCCTGGATCGAGAAGCTGCTGATG
CAAATGGAACCTGGGACCCCGCTA -> AAATGGAACCTGGGACCCCGCTAG
CTTTCGAATACATCAATCGTCGCC -> TTTCGAATACATCAATCGTCGCCG
CTCCTCCGTCTGGAAGGACACTTT -> TCCTCCGTCTGGAAGGACACTTTT
TCGCAACTTAAAGGCTTACGGTAT -> CGCAACTTAAAGGCTTACGGTATA
AATCCGCAGAACCCGCGCTGCTAG -> ATCCGCAGAACCCGCGCTGCTAGG
GAGAGTAGTGGTCTCGGAACGTGA -> AGAGTAGTGGTCTCGGAACGTGAA
CTTAGTACTCTAGGCCTTCACGTT -> TTAGTACTCTAGGCCTTCACGTTT
TGCGAGATTACGGTATGTGGGAGC -> GCGAGATTACGGTATGTGGGAGCA
TTTAAGGCCTTACAAGTCAGGTCA -> TTAAGGCCTTACAAGTCAGGTCAT
GGGCGATTGACTTCCCGGCTAACT -> GGCGATTGACTTCCCGGCTAACTA
TTATCAAACCCACCAGTATACCCA -> TATCAAACCCACCAGTATACCCAA
TACTCTAGGCCTTCACGTTTTGTT -> ACTCTAGGCCTTCACGTTTTGTTT
GAACTGCGTAATGCTCGTAGCAAT -> AACTGCGTAATGCTCGTAGCAATA
CGGTAATCTTAGTACTCTAGGCCT -> GGTAATCTTAGTACTCTAGGCCTT
TGACATGGACGGCGAGGGGCGGCC -> GACATGGACGGCGAGGGGCGGCCC
GACTTCCCGGCTAACTATTTTCAG -> ACTTCCCGGCTAACTATTTTCAGT
CATTGTTTCGTTGCCCCCGTCTTC -> ATTGTTTCGTTGCCCCCGTCTTCG
CTAAGATAATCGCAACTTAAAGGC -> TAAGATAATCGCAACTTAAAGGCT
AGGGGCTGAGGTGACTGGATGGTC -> GGGGCTGAGGTGACTGGATGGTCG
ACTCTAACATCTACCGATATTTGT -> CTCTAACATCTACCGATATTTGTG
GTTTCGCTTGATATCAGCTGGTCC -> TTTCGCTTGATATCAGCTGGTCCA
CAGTAGCCATACTCCAATGCCGAG -> AGTAGCCATACTCCAATGCCGAGT
AGTATTCGGCTTACACACGCATGT -> GTATTCGGCTTACACACGCATGTA
CACCACCCTGCAAGTAGAGCCGGA -> ACCACCCTGCAAGTAGAGCCGGAG
TATACCCTGTCATACTTACCTTAA -> ATACCCTGTCATACTTACCTTAAA
ACGTTGAGATAGCACCTGATCCTC -> CGTTGAGATAGCACCTGATCCTCT
CGCGCTGCTAGGAGCCCGAAGCGG -> GCGCTGCTAGGAGCCCGAAGCGGT
ACACACGTAATCCGCAGAACCCGC -> CACACGTAATCCGCAGAACCCGCG
TGCCTTGTACAAGTATCAGCGCCA -> GCCTTGTACAAGTATCAGCGCCAT
GCTTTAATAGTGGGTATGGGGGCG -> CTTTAATAGTGGGTATGGGGGCGA
GGTAGTCCCAATTACTGGAGTAAC -> GTAGTCCCAATTACTGGAGTAACA
CTTTGTCTCGTCATTCCGAAGTAC -> TTTGTCTCGTCATTCCGAAGTACA
GTGCACATTCTCACCTGCAGTAAA -> TGCACATTCTCACCTGCAGTAAAT
AACTTATCACCACCCTGCAAGTAG -> ACTTATCACCACCCTGCAAGTAGA
CAGTTTAGCCTAAAGCAGGACTTA -> AGTTTAGCCTAAAGCAGGACTTAT
GAGGGTCATTGTTAGGTGTTTAGC -> AGGGTCATTGTTAGGTGTTTAGCC
AAGACGAAATCTAATGACTGTTAC -> AGACGAAATCTAATGACTGTTACG
GTATCCAGTTTCAAATAAGACGAA -> TATCCAGTTTCAAATAAGACGAAA
GGTGAGAGTAGTGGTCTCGGAACG -> GTGAGAGTAGTGGTCTCGGAACGT
CTTGTTATCGCCTCCTTTGTCTCG -> TTGTTATCGCCTCCTTTGTCTCGT
CGCTTGATATCAGCTGGTCCACGA -> GCTTGATATCAGCTGGTCCACGAT
ATTTAGGGGCTGAGGTGACTGGAT -> TTTAGGGGCTGAGGTGACTGGATG
AAAACGTGACATAGCTTAAACAGA -> AAACGTGACATAGCTTAAACAGAT
CATCGATGCTTTAATAGTGGGTAT -> ATCGATGCTTTAATAGTGGGTATG
TAGTACTTTCCCGAAAATAAACCT -> AGTACTTTCCCGAAAATAAACCTT
ACTTAGTATCCAGTTTCAAATAAG -> CTTAGTATCCAGTTTCAAATAAGA
ATCTTGACATTTTGTCTTGTCACA -> TCTTGACATTTTGTCTTGTCACAG
TACACACGCATGTAGTACCTGGCA -> ACACACGCATGTAGTACCTGGCAC
TGGGACCGGAACCGAGAAGAATCG -> GGGACCGGAACCGAGAAGAATCGA
AGCCGCGGAGAAGATGTCGACACA -> GCCGCGGAGAAGATGTCGACACAT
GGCCGTCCTGGGACCGGAACCGAG -> GCCGTCCTGGGACCGGAACCGAGA
AACCGAGAAGAATCGATTTCATAC -> ACCGAGAAGAATCGATTTCATACT
TGCCCAAAATGTCCCGGCCGTCCT -> GCCCAAAATGTCCCGGCCGTCCTG
TACTGAATCCATTAGGGCGCAATT -> ACTGAATCCATTAGGGCGCAATTT
ATATGCTGGAATCTTGACATTTTG -> TATGCTGGAATCTTGACATTTTGT
TGAGGGTATGGTTGCGCCACCCCC -> GAGGGTATGGTTGCGCCACCCCCA
CCAAAATGTCCCGGCCGTCCTGGG -> CAAAATGTCCCGGCCGTCCTGGGA
CTGCGTAATGCTCGTAGCAATATC -> TGCGTAATGCTCGTAGCAATATCT
ACTCGTGCACATTCTCACCTGCAG -> CTCGTGCACATTCTCACCTGCAGT
TACCGCACGATCAGGCATATGCTG -> ACCGCACGATCAGGCATATGCTGG
GCCCTAGTACTTTCCCGAAAATAA -> CCCTAGTACTTTCCCGAAAATAAA
ACTCCATCTCTATACCCTGTCATA -> CTCCATCTCTATACCCTGTCATAC
GACTGGATGGTCGGCACGAACTTA -> ACTGGATGGTCGGCACGAACTTAA
AAATGCCGTTTCGCTTGATATCAG -> AATGCCGTTTCGCTTGATATCAGC
TCATTGCCTGCTTTAGGAAATCTG -> CATTGCCTGCTTTAGGAAATCTGA
ACACGTAATCCGCAGAACCCGCGC -> CACGTAATCCGCAGAACCCGCGCT
CTGGATCGAGAAGCTGCTGATGGG -> TGGATCGAGAAGCTGCTGATGGGT
CTCAAGTAACTGTGACAGGGTACA -> TCAAGTAACTGTGACAGGGTACAC
GAAGGCTCTTCTGCGCGGTACCAG -> AAGGCTCTTCTGCGCGGTACCAGT
GGTATCTTCTTCAAACAATTCCTT -> GTATCTTCTTCAAACAATTCCTTC
TTTGAGGGTATGGTTGCGCCACCC -> TTGAGGGTATGGTTGCGCCACCCC
GTATACCAATCAACTATGTTGTGT -> TATACCAATCAACTATGTTGTGTA
GTGTCCCTCGAATTTACAGCTCTG -> TGTCCCTCGAATTTACAGCTCTGT
TTATAAACTTATCACCACCCTGCA -> TATAAACTTATCACCACCCTGCAA
AGTGGCAGTACGGGGCTCACTCCT -> GTGGCAGTACGGGGCTCACTCCTC
GTTTCGTTGCCCCCGTCTTCGGGT -> TTTCGTTGCCCCCGTCTTCGGGTA
AAAGAATGTGCACTTGCATCTTGT -> AAGAATGTGCACTTGCATCTTGTC
ACATCTACCGATATTTGTGGAGCA -> CATCTACCGATATTTGTGGAGCAA
AGCAAGGTCCTCACTTCGTCCTGT -> GCAAGGTCCTCACTTCGTCCTGTA
TACATCAATCGTCGCCGCAGCGAA -> ACATCAATCGTCGCCGCAGCGAAC
CCGGTAGTCCCAATTACTGGAGTA -> CGGTAGTCCCAATTACTGGAGTAA
GCACGGGTCAAATACTTTCGAATA -> CACGGGTCAAATACTTTCGAATAC
ACGTAAGGTGCCAGTTTCCCGCGT -> CGTAAGGTGCCAGTTTCCCGCGTA
ATCTTGTCAGTAGCCATACTCCAA -> TCTTGTCAGTAGCCATACTCCAAT
CACGTAATCCGCAGAACCCGCGCT -> ACGTAATCCGCAGAACCCGCGCTG
TAGTGGTCTCGGAACGTGAAGACC -> AGTGGTCTCGGAACGTGAAGACCG
ACATTCTCACCTGCAGTAAATTTA -> CATTCTCACCTGCAGTAAATTTAG
TCCGTCTGGAAGGACACTTTTGAA -> CCGTCTGGAAGGACACTTTTGAAC
CACCCCCACATGTTCCCTGACAAA -> ACCCCCACATGTTCCCTGACAAAT
TGTTTAGCCGCGGAGAAGATGTCG -> GTTTAGCCGCGGAGAAGATGTCGA
ATCAGCTGGTCCACGATCCCAGAT -> TCAGCTGGTCCACGATCCCAGATC
ACTTAATATGAGGGTCATTGTTAG -> CTTAATATGAGGGTCATTGTTAGG
ATTCATTGTTTCGTTGCCCCCGTC -> TTCATTGTTTCGTTGCCCCCGTCT
ACGGCGAGGGGCGGCCCTAGTACT -> CGGCGAGGGGCGGCCCTAGTACTT
ACAATTCCTTCGGAGTATTCGGCT -> CAATTCCTTCGGAGTATTCGGCTT
TAGCCATACTCCAATGCCGAGTTG -> AGCCATACTCCAATGCCGAGTTGT
CGTTCATCCCCATGCTCGTGGTGC -> GTTCATCCCCATGCTCGTGGTGCC
TATCTTCTTCAAACAATTCCTTCG -> ATCTTCTTCAAACAATTCCTTCGG
GGAAGGACACTTTTGAACAACCTT -> GAAGGACACTTTTGAACAACCTTG
CGCATGTAGTACCTGGCACCATTG -> GCATGTAGTACCTGGCACCATTGG
CATAGCTTAAACAGATTTCGGAAC -> ATAGCTTAAACAGATTTCGGAACA
GCGGTTGACAAAACGTGACATAGC -> CGGTTGACAAAACGTGACATAGCT
AACACAAAACGCGTCATGGCGACT -> ACACAAAACGCGTCATGGCGACTT
TAGGCCTTCACGTTTTGTTTAGAC -> AGGCCTTCACGTTTTGTTTAGACC
CCCTCAAGTAACTGTGACAGGGTA -> CCTCAAGTAACTGTGACAGGGTAC
CAGTATACCCAAAGAATGTGCACT -> AGTATACCCAAAGAATGTGCACTT
CTCCTTTGTCTCGTCATTCCGAAG -> TCCTTTGTCTCGTCATTCCGAAGT
ACTTGGTGTCCCTCGAATTTACAG -> CTTGGTGTCCCTCGAATTTACAGC
GTGACATAGCTTAAACAGATTTCG -> TGACATAGCTTAAACAGATTTCGG
CTCACCTGCAGTAAATTTAGGGGC -> TCACCTGCAGTAAATTTAGGGGCT
GTTGCGCCACCCCCACATGTTCCC -> TTGCGCCACCCCCACATGTTCCCT
ACGCCCACTCCATCTCTATACCCT -> CGCCCACTCCATCTCTATACCCTG
ACGAATGAGACATATTCCCGGTGT -> CGAATGAGACATATTCCCGGTGTC
TACTTACCTTAAATCTTTATGAGT -> ACTTACCTTAAATCTTTATGAGTT
AAACAGATTTCGGAACATATAACA -> AACAGATTTCGGAACATATAACAA
TTTCGCTTGATATCAGCTGGTCCA -> TTCGCTTGATATCAGCTGGTCCAC
CGAGATTACGGTATGTGGGAGCAG -> GAGATTACGGTATGTGGGAGCAGC
CGTCCTGGGACCGGAACCGAGAAG -> GTCCTGGGACCGGAACCGAGAAGA
AATCTTGACATTTTGTCTTGTCAC -> ATCTTGACATTTTGTCTTGTCACA
GCTGATGGGTGAGAGTAGTGGTCT -> CTGATGGGTGAGAGTAGTGGTCTC
ACTTAAAGGCTTACGGTATACCAA -> CTTAAAGGCTTACGGTATACCAAT
ATGGCGACTTGCCCAAAATGTCCC -> TGGCGACTTGCCCAAAATGTCCCG
GGGTACACACGTAATCCGCAGAAC -> GGTACACACGTAATCCGCAGAACC
GATCAGGCATATGCTGGAATCTTG -> ATCAGGCATATGCTGGAATCTTGA
TACCAATCAACTATGTTGTGTAGA -> ACCAATCAACTATGTTGTGTAGAC
CTTATCAAACCCACCAGTATACCC -> TTATCAAACCCACCAGTATACCCA
TCAAAGTGTGATCACTACTTCTTT -> CAAAGTGTGATCACTACTTCTTTG
AGTTTCCCGCGTAATATTCATTTA -> GTTTCCCGCGTAATATTCATTTAA
TCAGCTGGTCCACGATCCCAGATC -> CAGCTGGTCCACGATCCCAGATCG
TGTTCCCTGACAAATGCCGTTTCG -> GTTCCCTGACAAATGCCGTTTCGC
ATGCCGAGTTGTCTGGGCGTTCAT -> TGCCGAGTTGTCTGGGCGTTCATC
CGCACGTTGAGATAGCACCTGATC -> GCACGTTGAGATAGCACCTGATCC
CCCCCACATGTTCCCTGACAAATG -> CCCCACATGTTCCCTGACAAATGC
CGACTTGCCCAAAATGTCCCGGCC -> GACTTGCCCAAAATGTCCCGGCCG
GGGACCCCGCTAGTTTGACCAGTC -> GGACCCCGCTAGTTTGACCAGTCT
CTTGATATCAGCTGGTCCACGATC -> TTGATATCAGCTGGTCCACGATCC
AAGTATCAGCGCCATCGATGCTTT -> AGTATCAGCGCCATCGATGCTTTA
AGATAGCACCTGATCCTCTTCCAT -> GATAGCACCTGATCCTCTTCCATA
CCCTGGATCGAGAAGCTGCTGATG -> CCTGGATCGAGAAGCTGCTGATGG
TGGAGCAAGGTCCTCACTTCGTCC -> GGAGCAAGGTCCTCACTTCGTCCT
ACAAGTCGGTAGGCCACACGTGAC -> CAAGTCGGTAGGCCACACGTGACA
CAAAACGCTTATTCGACTCACCTA -> AAAACGCTTATTCGACTCACCTAA
GGATCGAGAAGCTGCTGATGGGTG -> GATCGAGAAGCTGCTGATGGGTGA
AGTCCCAATTACTGGAGTAACACA -> GTCCCAATTACTGGAGTAACACAA
TTACACACGCATGTAGTACCTGGC -> TACACACGCATGTAGTACCTGGCA
CTTCTTCAAACAATTCCTTCGGAG -> TTCTTCAAACAATTCCTTCGGAGT
ATGGGGGCGATTGACTTCCCGGCT -> TGGGGGCGATTGACTTCCCGGCTA
AAGTAGAGCCGGAGTTCGGTAATC -> AGTAGAGCCGGAGTTCGGTAATCT
TATGCTGGAATCTTGACATTTTGT -> ATGCTGGAATCTTGACATTTTGTC
CCTTGTTATCGCCTCCTTTGTCTC -> CTTGTTATCGCCTCCTTTGTCTCG
TGGGTATGGGGGCGATTGACTTCC -> GGGTATGGGGGCGATTGACTTCCC
CCCCCGTCTTCGGGTAGGTATCTT -> CCCCGTCTTCGGGTAGGTATCTTC
AGATGATTCATTGTTTCGTTGCCC -> GATGATTCATTGTTTCGTTGCCCC
AGGGTCATTGTTAGGTGTTTAGCC -> GGGTCATTGTTAGGTGTTTAGCCG
AGATTGGATCGCCGGTGACGCTAC -> GATTGGATCGCCGGTGACGCTACT
GCCATCGATGCTTTAATAGTGGGT -> CCATCGATGCTTTAATAGTGGGTA
TCAGGCATATGCTGGAATCTTGAC -> CAGGCATATGCTGGAATCTTGACA
ATAATCGCAACTTAAAGGCTTACG -> TAATCGCAACTTAAAGGCTTACGG
CTGGATGGTCGGCACGAACTTAAT -> TGGATGGTCGGCACGAACTTAATA
GTACTTTCCCGAAAATAAACCTTC -> TACTTTCCCGAAAATAAACCTTCC
TCCCGGCTAACTATTTTCAGTGGC -> CCCGGCTAACTATTTTCAGTGGCA
AGGCCACCATCATTACTCTAACAT -> GGCCACCATCATTACTCTAACATC
CCGAAGCGGTTGACAAAACGTGAC -> CGAAGCGGTTGACAAAACGTGACA
CCGTCTTCGGGTAGGTATCTTCTT -> CGTCTTCGGGTAGGTATCTTCTTC
TATTCATTTAACATGCCCAAAACG -> ATTCATTTAACATGCCCAAAACGC
TCCTTAATACCGCACGATCAGGCA -> CCTTAATACCGCACGATCAGGCAT
ACCAGTCTCTCCCTGGATCGAGAA -> CCAGTCTCTCCCTGGATCGAGAAG
CTCCCTGGATCGAGAAGCTGCTGA -> TCCCTGGATCGAGAAGCTGCTGAT
TGATATCAGCTGGTCCACGATCCC -> GATATCAGCTGGTCCACGATCCCA
TTTATGAGTTTCCTTAATACCGCA -> TTATGAGTTTCCTTAATACCGCAC
AGCCATACTCCAATGCCGAGTTGT -> GCCATACTCCAATGCCGAGTTGTC
GCCATACTCCAATGCCGAGTTGTC -> CCATACTCCAATGCCGAGTTGTCT
ATCAAACCCACCAGTATACCCAAA -> TCAAACCCACCAGTATACCCAAAG
ATGAGGGTCATTGTTAGGTGTTTA -> TGAGGGTCATTGTTAGGTGTTTAG
GTGACAGGGTACACACGTAATCCG -> TGACAGGGTACACACGTAATCCGC
AAGGCTCTTCTGCGCGGTACCAGT -> AGGCTCTTCTGCGCGGTACCAGTT
CAAAGAATGTGCACTTGCATCTTG -> AAAGAATGTGCACTTGCATCTTGT
GCCTTGTACAAGTATCAGCGCCAT -> CCTTGTACAAGTATCAGCGCCATC
TATCAAACCCACCAGTATACCCAA -> ATCAAACCCACCAGTATACCCAAA
TCACTCCTCCGTCTGGAAGGACAC -> CACTCCTCCGTCTGGAAGGACACT
TTGTGCGGTCCGAAGGCCCAGATG -> TGTGCGGTCCGAAGGCCCAGATGT
ACTTATCAAACCCACCAGTATACC -> CTTATCAAACCCACCAGTATACCC
AGAATGTGCACTTGCATCTTGTCA -> GAATGTGCACTTGCATCTTGTCAG
TCGTCATTCCGAAGTACACTTAGT -> CGTCATTCCGAAGTACACTTAGTA
CAAAGTGTGATCACTACTTCTTTG -> AAAGTGTGATCACTACTTCTTTGC
CTGCGAGATTACGGTATGTGGGAG -> TGCGAGATTACGGTATGTGGGAGC
GGTCATTGCCTGCTTTAGGAAATC -> GTCATTGCCTGCTTTAGGAAATCT
TGACTGTTACGAATGAGACATATT -> GACTGTTACGAATGAGACATATTC
TGAGAGTAGTGGTCTCGGAACGTG -> GAGAGTAGTGGTCTCGGAACGTGA
ACGAACTTAATATGAGGGTCATTG -> CGAACTTAATATGAGGGTCATTGT
GCTTACGGTATACCAATCAACTAT -> CTTACGGTATACCAATCAACTATG
GGTAGGTATCTTCTTCAAACAATT -> GTAGGTATCTTCTTCAAACAATTC
TCTCACCTGCAGTAAATTTAGGGG -> CTCACCTGCAGTAAATTTAGGGGC
GGAACATATAACAATGAGGATACA -> GAACATATAACAATGAGGATACAC
GTATACAACGCTTATAAACTTATC -> TATACAACGCTTATAAACTTATCA
CTAACATCTACCGATATTTGTGGA -> TAACATCTACCGATATTTGTGGAG
CCTCAAGTAACTGTGACAGGGTAC -> CTCAAGTAACTGTGACAGGGTACA
GGCAGTACGGGGCTCACTCCTCCG -> GCAGTACGGGGCTCACTCCTCCGT
CAAATAAGACGAAATCTAATGACT -> AAATAAGACGAAATCTAATGACTG
TGGATCGAGAAGCTGCTGATGGGT -> GGATCGAGAAGCTGCTGATGGGTG
CATGGCGACTTGCCCAAAATGTCC -> ATGGCGACTTGCCCAAAATGTCCC
TGTCGACACATCCCTCAAGTAACT -> GTCGACACATCCCTCAAGTAACTG
CTTGTCACAGCGTGGCGTTTGAGG -> TTGTCACAGCGTGGCGTTTGAGGG
GCAAGGTCCTCACTTCGTCCTGTA -> CAAGGTCCTCACTTCGTCCTGTAG
TGTCACAGCGTGGCGTTTGAGGGT -> GTCACAGCGTGGCGTTTGAGGGTA
CACTTAGTATCCAGTTTCAAATAA -> ACTTAGTATCCAGTTTCAAATAAG
AATGCTCGTAGCAATATCTACGGT -> ATGCTCGTAGCAATATCTACGGTA
GATTCATTGTTTCGTTGCCCCCGT -> ATTCATTGTTTCGTTGCCCCCGTC
AGACGTAGAGATTGGATCGCCGGT -> GACGTAGAGATTGGATCGCCGGTG
AGAAGATGTCGACACATCCCTCAA -> GAAGATGTCGACACATCCCTCAAG
TCATTGTTAGGTGTTTAGCCGCGG -> CATTGTTAGGTGTTTAGCCGCGGA
AAGGCCACCATCATTACTCTAACA -> AGGCCACCATCATTACTCTAACAT
CACACGTGACATGGACGGCGAGGG -> ACACGTGACATGGACGGCGAGGGG
GGTAGGCCACACGTGACATGGACG -> GTAGGCCACACGTGACATGGACGG
TGCCGTTTCGCTTGATATCAGCTG -> GCCGTTTCGCTTGATATCAGCTGG
AATTTAGGGGCTGAGGTGACTGGA -> ATTTAGGGGCTGAGGTGACTGGAT
AAGCGGTTGACAAAACGTGACATA -> AGCGGTTGACAAAACGTGACATAG
ACTGAATCCATTAGGGCGCAATTT -> CTGAATCCATTAGGGCGCAATTTA
CTTCCCGGCTAACTATTTTCAGTG -> TTCCCGGCTAACTATTTTCAGTGG
TACGGGGCTCACTCCTCCGTCTGG -> ACGGGGCTCACTCCTCCGTCTGGA
TGACCAGTCTCTCCCTGGATCGAG -> GACCAGTCTCTCCCTGGATCGAGA
CGCGTCATGGCGACTTGCCCAAAA -> GCGTCATGGCGACTTGCCCAAAAT
TCGACTCACCTAAGGCCACCATCA -> CGACTCACCTAAGGCCACCATCAT
GTATGGGGGCGATTGACTTCCCGG -> TATGGGGGCGATTGACTTCCCGGC
ATGGTCGGCACGAACTTAATATGA -> TGGTCGGCACGAACTTAATATGAG
CAGCGCCATCGATGCTTTAATAGT -> AGCGCCATCGATGCTTTAATAGTG
GACTGTTACGAATGAGACATATTC -> ACTGTTACGAATGAGACATATTCC
CTCGTAGCAATATCTACGGTACAA -> TCGTAGCAATATCTACGGTACAAG
TTTGCTCCACATCCAAGGTCAAAG -> TTGCTCCACATCCAAGGTCAAAGT
TGCTCGTGGTGCCTTGTACAAGTA -> GCTCGTGGTGCCTTGTACAAGTAT
CTCCAATGCCGAGTTGTCTGGGCG -> TCCAATGCCGAGTTGTCTGGGCGT
AGAGATTGGATCGCCGGTGACGCT -> GAGATTGGATCGCCGGTGACGCTA
CTCTCCCTGGATCGAGAAGCTGCT -> TCTCCCTGGATCGAGAAGCTGCTG
ACACGTGACATGGACGGCGAGGGG -> CACGTGACATGGACGGCGAGGGGC
GGCCCTAGTACTTTCCCGAAAATA -> GCCCTAGTACTTTCCCGAAAATAA
AAAGGCTTACGGTATACCAATCAA -> AAGGCTTACGGTATACCAATCAAC
CGGTGACGCTACTTGGTGTCCCTC -> GGTGACGCTACTTGGTGTCCCTCG
CCTGGGACCCCGCTAGTTTGACCA -> CTGGGACCCCGCTAGTTTGACCAG
ACGGTATGTGGGAGCAGCCCGCAG -> CGGTATGTGGGAGCAGCCCGCAGA
CTAAGGCCACCATCATTACTCTAA -> TAAGGCCACCATCATTACTCTAAC
CTGATGGGTGAGAGTAGTGGTCTC -> TGATGGGTGAGAGTAGTGGTCTCG
TCAGTAGCCATACTCCAATGCCGA -> CAGTAGCCATACTCCAATGCCGAG
ATCGCGCTTACTGACATTTTGGTT -> TCGCGCTTACTGACATTTTGGTTA
GTAGACGTAGAGATTGGATCGCCG -> TAGACGTAGAGATTGGATCGCCGG
TGCTAGGAGCCCGAAGCGGTTGAC -> GCTAGGAGCCCGAAGCGGTTGACA
TTTCGTTGCCCCCGTCTTCGGGTA -> TTCGTTGCCCCCGTCTTCGGGTAG
CAAACCCACCAGTATACCCAAAGA -> AAACCCACCAGTATACCCAAAGAA
CTTCAAACAATTCCTTCGGAGTAT -> TTCAAACAATTCCTTCGGAGTATT
CGACTCACCTAAGGCCACCATCAT -> GACTCACCTAAGGCCACCATCATT
GCTGGTCCACGATCCCAGATCGCG -> CTGGTCCACGATCCCAGATCGCGC
GATGATTCATTGTTTCGTTGCCCC -> ATGATTCATTGTTTCGTTGCCCCC
CTAGGCCTTCACGTTTTGTTTAGA -> TAGGCCTTCACGTTTTGTTTAGAC
CTTATTCGACTCACCTAAGGCCAC -> TTATTCGACTCACCTAAGGCCACC
TTCGCTTGATATCAGCTGGTCCAC -> TCGCTTGATATCAGCTGGTCCACG
CTTTCCCGAAAATAAACCTTCCGG -> TTTCCCGAAAATAAACCTTCCGGT
CAACCTTGTGCGGTCCGAAGGCCC -> AACCTTGTGCGGTCCGAAGGCCCA
ATTTCGGAACATATAACAATGAGG -> TTTCGGAACATATAACAATGAGGA
GCTGGAATCTTGACATTTTGTCTT -> CTGGAATCTTGACATTTTGTCTTG
TAATCTTAGTACTCTAGGCCTTCA -> AATCTTAGTACTCTAGGCCTTCAC
AGAGCCGGAGTTCGGTAATCTTAG -> GAGCCGGAGTTCGGTAATCTTAGT
CCAAAACGCTTATTCGACTCACCT -> CAAAACGCTTATTCGACTCACCTA
AGGAGCCCGAAGCGGTTGACAAAA -> GGAGCCCGAAGCGGTTGACAAAAC
AAACCCACCAGTATACCCAAAGAA -> AACCCACCAGTATACCCAAAGAAT
GTTTAGACCGGTAGTCCCAATTAC -> TTTAGACCGGTAGTCCCAATTACT
TTAGAAAACGCCCACTCCATCTCT -> TAGAAAACGCCCACTCCATCTCTA
CTTACGGTATACCAATCAACTATG -> TTACGGTATACCAATCAACTATGT
CAATCAACTATGTTGTGTAGACGT -> AATCAACTATGTTGTGTAGACGTA
CCTGATCCTCTTCCATAAGATGAT -> CTGATCCTCTTCCATAAGATGATT
TTGGATTTAAGGCCTTACAAGTCA -> TGGATTTAAGGCCTTACAAGTCAG
GGTGACGCTACTTGGTGTCCCTCG -> GTGACGCTACTTGGTGTCCCTCGA
GATCGAGAAGCTGCTGATGGGTGA -> ATCGAGAAGCTGCTGATGGGTGAG
TGCACATTCTCACCTGCAGTAAAT -> GCACATTCTCACCTGCAGTAAATT
TTGATATCAGCTGGTCCACGATCC -> TGATATCAGCTGGTCCACGATCCC
CAGGGTACACACGTAATCCGCAGA -> AGGGTACACACGTAATCCGCAGAA
TCATACTGAATCCATTAGGGCGCA -> CATACTGAATCCATTAGGGCGCAA
ATCCAGTTTCAAATAAGACGAAAT -> TCCAGTTTCAAATAAGACGAAATC
GCGTTCATCCCCATGCTCGTGGTG -> CGTTCATCCCCATGCTCGTGGTGC
TTACTGACATTTTGGTTATAGGAC -> TACTGACATTTTGGTTATAGGACG
CCAATCAACTATGTTGTGTAGACG -> CAATCAACTATGTTGTGTAGACGT
TGCTTTAGGAAATCTGAAGGCTCT -> GCTTTAGGAAATCTGAAGGCTCTT
AACGCTTATTCGACTCACCTAAGG -> ACGCTTATTCGACTCACCTAAGGC
AAATTTAGGGGCTGAGGTGACTGG -> AATTTAGGGGCTGAGGTGACTGGA
ATATGAGGGTCATTGTTAGGTGTT -> TATGAGGGTCATTGTTAGGTGTTT
GTACAAGTCGGTAGGCCACACGTG -> TACAAGTCGGTAGGCCACACGTGA
CTCGGAACGTGAAGACCGCACGTT -> TCGGAACGTGAAGACCGCACGTTG
TAGAGCCGGAGTTCGGTAATCTTA -> AGAGCCGGAGTTCGGTAATCTTAG
TGTATACAACGCTTATAAACTTAT -> GTATACAACGCTTATAAACTTATC
CACGTTGAGATAGCACCTGATCCT -> ACGTTGAGATAGCACCTGATCCTC
GAACTCGTGCACATTCTCACCTGC -> AACTCGTGCACATTCTCACCTGCA
AGCAGCCCGCAGAACTGCGTAATG -> GCAGCCCGCAGAACTGCGTAATGC
TCTACGGTACAAGTCGGTAGGCCA -> CTACGGTACAAGTCGGTAGGCCAC
AAAACGCGTCATGGCGACTTGCCC -> AAACGCGTCATGGCGACTTGCCCA
CTTCGGAGTATTCGGCTTACACAC -> TTCGGAGTATTCGGCTTACACACG
GAATGAGACATATTCCCGGTGTCT -> AATGAGACATATTCCCGGTGTCTA
CTACCGATATTTGTGGAGCAAGGT -> TACCGATATTTGTGGAGCAAGGTC
GGGTCAAATACTTTCGAATACATC -> GGTCAAATACTTTCGAATACATCA
GTTCATCCCCATGCTCGTGGTGCC -> TTCATCCCCATGCTCGTGGTGCCT
GGGACCGGAACCGAGAAGAATCGA -> GGACCGGAACCGAGAAGAATCGAT
TAGGACGTAAGGTGCCAGTTTCCC -> AGGACGTAAGGTGCCAGTTTCCCG
CCTTCACGTTTTGTTTAGACCGGT -> CTTCACGTTTTGTTTAGACCGGTA
TCCAAGGTCAAAGTGTGATCACTA -> CCAAGGTCAAAGTGTGATCACTAC
GCGCGGTACCAGTTTAGCCTAAAG -> CGCGGTACCAGTTTAGCCTAAAGC
CTTAATACCGCACGATCAGGCATA -> TTAATACCGCACGATCAGGCATAT
CATGCTCGTGGTGCCTTGTACAAG -> ATGCTCGTGGTGCCTTGTACAAGT
ATCAACTATGTTGTGTAGACGTAG -> TCAACTATGTTGTGTAGACGTAGA
AAGGTGCCAGTTTCCCGCGTAATA -> AGGTGCCAGTTTCCCGCGTAATAT
CACAAAACGCGTCATGGCGACTTG -> ACAAAACGCGTCATGGCGACTTGC
GAACAACCTTGTGCGGTCCGAAGG -> AACAACCTTGTGCGGTCCGAAGGC
CCGATATTTGTGGAGCAAGGTCCT -> CGATATTTGTGGAGCAAGGTCCTC
AAAATAAACCTTCCGGTCGCTGCG -> AAATAAACCTTCCGGTCGCTGCGC
GAAAACGCCCACTCCATCTCTATA -> AAAACGCCCACTCCATCTCTATAC
TGCCCAAAACGCTTATTCGACTCA -> GCCCAAAACGCTTATTCGACTCAC
GAAAATAAACCTTCCGGTCGCTGC -> AAAATAAACCTTCCGGTCGCTGCG
CAATTCCTTCGGAGTATTCGGCTT -> AATTCCTTCGGAGTATTCGGCTTA
CCCAAAACGCTTATTCGACTCACC -> CCAAAACGCTTATTCGACTCACCT
GACGAAATCTAATGACTGTTACGA -> ACGAAATCTAATGACTGTTACGAA
AATATCTACGGTACAAGTCGGTAG -> ATATCTACGGTACAAGTCGGTAGG
CGGGGCTCACTCCTCCGTCTGGAA -> GGGGCTCACTCCTCCGTCTGGAAG
CTGACAAATGCCGTTTCGCTTGAT -> TGACAAATGCCGTTTCGCTTGATA
TCCTGGGACCGGAACCGAGAAGAA -> CCTGGGACCGGAACCGAGAAGAAT
ACCGCACGATCAGGCATATGCTGG -> CCGCACGATCAGGCATATGCTGGA
AACTCGTGCACATTCTCACCTGCA -> ACTCGTGCACATTCTCACCTGCAG
ACTGGATGGTCGGCACGAACTTAA -> CTGGATGGTCGGCACGAACTTAAT
GATGCTTTAATAGTGGGTATGGGG -> ATGCTTTAATAGTGGGTATGGGGG
CTTAAACAGATTTCGGAACATATA -> TTAAACAGATTTCGGAACATATAA
GATTACGGTATGTGGGAGCAGCCC -> ATTACGGTATGTGGGAGCAGCCCG
ACCTTGTTATCGCCTCCTTTGTCT -> CCTTGTTATCGCCTCCTTTGTCTC
GACAAATGCCGTTTCGCTTGATAT -> ACAAATGCCGTTTCGCTTGATATC
GCGTAATGCTCGTAGCAATATCTA -> CGTAATGCTCGTAGCAATATCTAC
TGTTACGAATGAGACATATTCCCG -> GTTACGAATGAGACATATTCCCGG
CATGGACGGCGAGGGGCGGCCCTA -> ATGGACGGCGAGGGGCGGCCCTAG
GAGGGGCGGCCCTAGTACTTTCCC -> AGGGGCGGCCCTAGTACTTTCCCG
ACCTGGCACCATTGGATTTAAGGC -> CCTGGCACCATTGGATTTAAGGCC
AAAACGCTTATTCGACTCACCTAA -> AAACGCTTATTCGACTCACCTAAG
TCTTCCATAAGATGATTCATTGTT -> CTTCCATAAGATGATTCATTGTTT
CCTTCCGGTCGCTGCGCTTTGCTC -> CTTCCGGTCGCTGCGCTTTGCTCC
CCCCGTCTTCGGGTAGGTATCTTC -> CCCGTCTTCGGGTAGGTATCTTCT
GTTTGACCAGTCTCTCCCTGGATC -> TTTGACCAGTCTCTCCCTGGATCG
CGCTGCGCTTTGCTCCACATCCAA -> GCTGCGCTTTGCTCCACATCCAAG
GAATCCATTAGGGCGCAATTTATG -> AATCCATTAGGGCGCAATTTATGA
CATGCCCAAAACGCTTATTCGACT -> ATGCCCAAAACGCTTATTCGACTC
CTATTTTCAGTGGCAGTACGGGGC -> TATTTTCAGTGGCAGTACGGGGCT
CCAGATGTATACAACGCTTATAAA -> CAGATGTATACAACGCTTATAAAC
CTCACTCCTCCGTCTGGAAGGACA -> TCACTCCTCCGTCTGGAAGGACAC
CTTGGTGTCCCTCGAATTTACAGC -> TTGGTGTCCCTCGAATTTACAGCT
TCCCTCAAGTAACTGTGACAGGGT -> CCCTCAAGTAACTGTGACAGGGTA
GTAACACAAAACGCGTCATGGCGA -> TAACACAAAACGCGTCATGGCGAC
TTAAATCTTTATGAGTTTCCTTAA -> TAAATCTTTATGAGTTTCCTTAAT
GCCTTCACGTTTTGTTTAGACCGG -> CCTTCACGTTTTGTTTAGACCGGT
TGTCATACTTACCTTAAATCTTTA -> GTCATACTTACCTTAAATCTTTAT
GCTCTGTATATGTGCTAAACTGCG -> CTCTGTATATGTGCTAAACTGCGA
AGCACGGGTCAAATACTTTCGAAT -> GCACGGGTCAAATACTTTCGAATA
CTGACATTTTGGTTATAGGACGTA -> TGACATTTTGGTTATAGGACGTAA
GCGGAGAAGATGTCGACACATCCC -> CGGAGAAGATGTCGACACATCCCT
AGGGCAAATGGAACCTGGGACCCC -> GGGCAAATGGAACCTGGGACCCCG
TAAACCTTCCGGTCGCTGCGCTTT -> AAACCTTCCGGTCGCTGCGCTTTG
CAAAATGTCCCGGCCGTCCTGGGA -> AAAATGTCCCGGCCGTCCTGGGAC
CTCACTTCGTCCTGTAGAGGGCAA -> TCACTTCGTCCTGTAGAGGGCAAA
GCTGCGCTTTGCTCCACATCCAAG -> CTGCGCTTTGCTCCACATCCAAGG
CGTCGCCGCAGCGAACTCGTGCAC -> GTCGCCGCAGCGAACTCGTGCACA
AGAGTAGTGGTCTCGGAACGTGAA -> GAGTAGTGGTCTCGGAACGTGAAG
CGCGGAGAAGATGTCGACACATCC -> GCGGAGAAGATGTCGACACATCCC
AAGGACACTTTTGAACAACCTTGT -> AGGACACTTTTGAACAACCTTGTG
GTCCCAATTACTGGAGTAACACAA -> TCCCAATTACTGGAGTAACACAAA
CCCAGATGTATACAACGCTTATAA -> CCAGATGTATACAACGCTTATAAA
GTATACCCAAAGAATGTGCACTTG -> TATACCCAAAGAATGTGCACTTGC
GGATTTAAGGCCTTACAAGTCAGG -> GATTTAAGGCCTTACAAGTCAGGT
TCCATCTCTATACCCTGTCATACT -> CCATCTCTATACCCTGTCATACTT
TACTGACATTTTGGTTATAGGACG -> ACTGACATTTTGGTTATAGGACGT
CGTGACATGGACGGCGAGGGGCGG -> GTGACATGGACGGCGAGGGGCGGC
CTCTAGGCCTTCACGTTTTGTTTA -> TCTAGGCCTTCACGTTTTGTTTAG
GGTTGCGCCACCCCCACATGTTCC -> GTTGCGCCACCCCCACATGTTCCC
TTAATAGTGGGTATGGGGGCGATT -> TAATAGTGGGTATGGGGGCGATTG
GAGACATATTCCCGGTGTCTAAGA -> AGACATATTCCCGGTGTCTAAGAT
ACAAGTATCAGCGCCATCGATGCT -> CAAGTATCAGCGCCATCGATGCTT
TTCGGTAATCTTAGTACTCTAGGC -> TCGGTAATCTTAGTACTCTAGGCC
AAGTACACTTAGTATCCAGTTTCA -> AGTACACTTAGTATCCAGTTTCAA
CTTTAGGAAATCTGAAGGCTCTTC -> TTTAGGAAATCTGAAGGCTCTTCT
TACAAGTCAGGTCATTGCCTGCTT -> ACAAGTCAGGTCATTGCCTGCTTT
ATGACTGTTACGAATGAGACATAT -> TGACTGTTACGAATGAGACATATT
AATCTAATGACTGTTACGAATGAG -> ATCTAATGACTGTTACGAATGAGA
CCCGCGTAATATTCATTTAACATG -> CCGCGTAATATTCATTTAACATGC
CTTACAAGTCAGGTCATTGCCTGC -> TTACAAGTCAGGTCATTGCCTGCT
CCACCAGTATACCCAAAGAATGTG -> CACCAGTATACCCAAAGAATGTGC
GCCAGTTTCCCGCGTAATATTCAT -> CCAGTTTCCCGCGTAATATTCATT
CAGATTTCGGAACATATAACAATG -> AGATTTCGGAACATATAACAATGA
TACGGTACAAGTCGGTAGGCCACA -> ACGGTACAAGTCGGTAGGCCACAC
TCGATGCTTTAATAGTGGGTATGG -> CGATGCTTTAATAGTGGGTATGGG
TCCTCCGTCTGGAAGGACACTTTT -> CCTCCGTCTGGAAGGACACTTTTG
ATCTTTATGAGTTTCCTTAATACC -> TCTTTATGAGTTTCCTTAATACCG
GCGCCACCCCCACATGTTCCCTGA -> CGCCACCCCCACATGTTCCCTGAC
TTCCGAAGTACACTTAGTATCCAG -> TCCGAAGTACACTTAGTATCCAGT
TTGCGCCACCCCCACATGTTCCCT -> TGCGCCACCCCCACATGTTCCCTG
TTAATATGAGGGTCATTGTTAGGT -> TAATATGAGGGTCATTGTTAGGTG
ATGTTCCCTGACAAATGCCGTTTC -> TGTTCCCTGACAAATGCCGTTTCG
TAACAATGAGGATACACCTTGTTA -> AACAATGAGGATACACCTTGTTAT
TAGGTGTTTAGCCGCGGAGAAGAT -> AGGTGTTTAGCCGCGGAGAAGATG
TTTAATAGTGGGTATGGGGGCGAT -> TTAATAGTGGGTATGGGGGCGATT
GCATGTAGTACCTGGCACCATTGG -> CATGTAGTACCTGGCACCATTGGA
AAACGTGACATAGCTTAAACAGAT -> AACGTGACATAGCTTAAACAGATT
TTCGAATACATCAATCGTCGCCGC -> TCGAATACATCAATCGTCGCCGCA
ATCAATCGTCGCCGCAGCGAACTC -> TCAATCGTCGCCGCAGCGAACTCG
CCGGAACCGAGAAGAATCGATTTC -> CGGAACCGAGAAGAATCGATTTCA
GAACGTGAAGACCGCACGTTGAGA -> AACGTGAAGACCGCACGTTGAGAT
TGACGCTACTTGGTGTCCCTCGAA -> GACGCTACTTGGTGTCCCTCGAAT
AGCTCTGTATATGTGCTAAACTGC -> GCTCTGTATATGTGCTAAACTGCG
ATGTGCTAAACTGCGAGATTACGG -> TGTGCTAAACTGCGAGATTACGGT
GTGCTAAACTGCGAGATTACGGTA -> TGCTAAACTGCGAGATTACGGTAT
CAAAACGTGACATAGCTTAAACAG -> AAAACGTGACATAGCTTAAACAGA
CCGTCCTGGGACCGGAACCGAGAA -> CGTCCTGGGACCGGAACCGAGAAG
TTACAGCTCTGTATATGTGCTAAA -> TACAGCTCTGTATATGTGCTAAAC
TTACCTTAAATCTTTATGAGTTTC -> TACCTTAAATCTTTATGAGTTTCC
CCTGTCATACTTACCTTAAATCTT -> CTGTCATACTTACCTTAAATCTTT
AATCGATTTCATACTGAATCCATT -> ATCGATTTCATACTGAATCCATTA
GAGGATACACCTTGTTATCGCCTC -> AGGATACACCTTGTTATCGCCTCC
TGGCAGTACGGGGCTCACTCCTCC -> GGCAGTACGGGGCTCACTCCTCCG
CTTAAAGGCTTACGGTATACCAAT -> TTAAAGGCTTACGGTATACCAATC
TTATAGGACGTAAGGTGCCAGTTT -> TATAGGACGTAAGGTGCCAGTTTC
AGTACTTTCCCGAAAATAAACCTT -> GTACTTTCCCGAAAATAAACCTTC
GTCTAAGATAATCGCAACTTAAAG -> TCTAAGATAATCGCAACTTAAAGG
TATACAACGCTTATAAACTTATCA -> ATACAACGCTTATAAACTTATCAC
TCGACACATCCCTCAAGTAACTGT -> CGACACATCCCTCAAGTAACTGTG
AGAACCCGCGCTGCTAGGAGCCCG -> GAACCCGCGCTGCTAGGAGCCCGA
GTCAGGTCATTGCCTGCTTTAGGA -> TCAGGTCATTGCCTGCTTTAGGAA
GCATATGCTGGAATCTTGACATTT -> CATATGCTGGAATCTTGACATTTT
GAAATCTGAAGGCTCTTCTGCGCG -> AAATCTGAAGGCTCTTCTGCGCGG
ATATCAGCTGGTCCACGATCCCAG -> TATCAGCTGGTCCACGATCCCAGA
ACGGTATACCAATCAACTATGTTG -> CGGTATACCAATCAACTATGTTGT
GGCATATGCTGGAATCTTGACATT -> GCATATGCTGGAATCTTGACATTT
AACAATGAGGATACACCTTGTTAT -> ACAATGAGGATACACCTTGTTATC
AATGTCCCGGCCGTCCTGGGACCG -> ATGTCCCGGCCGTCCTGGGACCGG
TGGAAGGACACTTTTGAACAACCT -> GGAAGGACACTTTTGAACAACCTT
TCCACGATCCCAGATCGCGCTTAC -> CCACGATCCCAGATCGCGCTTACT
CCGGTCGCTGCGCTTTGCTCCACA -> CGGTCGCTGCGCTTTGCTCCACAT
CATGTTCCCTGACAAATGCCGTTT -> ATGTTCCCTGACAAATGCCGTTTC
TTAGCCTAAAGCAGGACTTATCAA -> TAGCCTAAAGCAGGACTTATCAAA
TACACACGTAATCCGCAGAACCCG -> ACACACGTAATCCGCAGAACCCGC
TGCCTGCTTTAGGAAATCTGAAGG -> GCCTGCTTTAGGAAATCTGAAGGC
CCAATTACTGGAGTAACACAAAAC -> CAATTACTGGAGTAACACAAAACG
ATCCTCTTCCATAAGATGATTCAT -> TCCTCTTCCATAAGATGATTCATT
TTAGGAAATCTGAAGGCTCTTCTG -> TAGGAAATCTGAAGGCTCTTCTGC
AATGAGACATATTCCCGGTGTCTA -> ATGAGACATATTCCCGGTGTCTAA
CTGCTTTAGGAAATCTGAAGGCTC -> TGCTTTAGGAAATCTGAAGGCTCT
TTTTGTTTAGACCGGTAGTCCCAA -> TTTGTTTAGACCGGTAGTCCCAAT
GGTGCCAGTTTCCCGCGTAATATT -> GTGCCAGTTTCCCGCGTAATATTC
GATTGGATCGCCGGTGACGCTACT -> ATTGGATCGCCGGTGACGCTACTT
GTCCACGATCCCAGATCGCGCTTA -> TCCACGATCCCAGATCGCGCTTAC
ACTTCCCGGCTAACTATTTTCAGT -> CTTCCCGGCTAACTATTTTCAGTG
CACATTCTCACCTGCAGTAAATTT -> ACATTCTCACCTGCAGTAAATTTA
TAGGGGCTGAGGTGACTGGATGGT -> AGGGGCTGAGGTGACTGGATGGTC
CGCTTTGCTCCACATCCAAGGTCA -> GCTTTGCTCCACATCCAAGGTCAA
ACCGCACGTTGAGATAGCACCTGA -> CCGCACGTTGAGATAGCACCTGAT
CTTCGTCCTGTAGAGGGCAAATGG -> TTCGTCCTGTAGAGGGCAAATGGA
TGCTAAACTGCGAGATTACGGTAT -> GCTAAACTGCGAGATTACGGTATG
ACCAATCAACTATGTTGTGTAGAC -> CCAATCAACTATGTTGTGTAGACG
CGCTTATTCGACTCACCTAAGGCC -> GCTTATTCGACTCACCTAAGGCCA
CACTTGCATCTTGTCAGTAGCCAT -> ACTTGCATCTTGTCAGTAGCCATA
GTAGAGATTGGATCGCCGGTGACG -> TAGAGATTGGATCGCCGGTGACGC
GTACGGGGCTCACTCCTCCGTCTG -> TACGGGGCTCACTCCTCCGTCTGG
CATACTTACCTTAAATCTTTATGA -> ATACTTACCTTAAATCTTTATGAG
CAGATCGCGCTTACTGACATTTTG -> AGATCGCGCTTACTGACATTTTGG
GGCACGAACTTAATATGAGGGTCA -> GCACGAACTTAATATGAGGGTCAT
ATACTTACCTTAAATCTTTATGAG -> TACTTACCTTAAATCTTTATGAGT
GCGAACTCGTGCACATTCTCACCT -> CGAACTCGTGCACATTCTCACCTG
GAAGGCCCAGATGTATACAACGCT -> AAGGCCCAGATGTATACAACGCTT
AATCTTTATGAGTTTCCTTAATAC -> ATCTTTATGAGTTTCCTTAATACC
TATCTACGGTACAAGTCGGTAGGC -> ATCTACGGTACAAGTCGGTAGGCC
GTGACTGGATGGTCGGCACGAACT -> TGACTGGATGGTCGGCACGAACTT
GCGCTTACTGACATTTTGGTTATA -> CGCTTACTGACATTTTGGTTATAG
GATTTCATACTGAATCCATTAGGG -> ATTTCATACTGAATCCATTAGGGC
TTCTGCGCGGTACCAGTTTAGCCT -> TCTGCGCGGTACCAGTTTAGCCTA
TTCAAACAATTCCTTCGGAGTATT -> TCAAACAATTCCTTCGGAGTATTC
CACAGCGTGGCGTTTGAGGGTATG -> ACAGCGTGGCGTTTGAGGGTATGG
AGGAAATCTGAAGGCTCTTCTGCG -> GGAAATCTGAAGGCTCTTCTGCGC
TGACTTCCCGGCTAACTATTTTCA -> GACTTCCCGGCTAACTATTTTCAG
GGTGTCTAAGATAATCGCAACTTA -> GTGTCTAAGATAATCGCAACTTAA
ACTGGAGTAACACAAAACGCGTCA -> CTGGAGTAACACAAAACGCGTCAT
CACGATCAGGCATATGCTGGAATC -> ACGATCAGGCATATGCTGGAATCT
GTCACAGCGTGGCGTTTGAGGGTA -> TCACAGCGTGGCGTTTGAGGGTAT
CAAATACTTTCGAATACATCAATC -> AAATACTTTCGAATACATCAATCG
ACATGGACGGCGAGGGGCGGCCCT -> CATGGACGGCGAGGGGCGGCCCTA
ACGATCCCAGATCGCGCTTACTGA -> CGATCCCAGATCGCGCTTACTGAC
CTGCAAGTAGAGCCGGAGTTCGGT -> TGCAAGTAGAGCCGGAGTTCGGTA
TATCAGCTGGTCCACGATCCCAGA -> ATCAGCTGGTCCACGATCCCAGAT
AGGTGACTGGATGGTCGGCACGAA -> GGTGACTGGATGGTCGGCACGAAC
GGGGCTCACTCCTCCGTCTGGAAG -> GGGCTCACTCCTCCGTCTGGAAGG
AGGCCTTCACGTTTTGTTTAGACC -> GGCCTTCACGTTTTGTTTAGACCG
GGAACCGAGAAGAATCGATTTCAT -> GAACCGAGAAGAATCGATTTCATA
ATTCCGAAGTACACTTAGTATCCA -> TTCCGAAGTACACTTAGTATCCAG
CGAAAATAAACCTTCCGGTCGCTG -> GAAAATAAACCTTCCGGTCGCTGC
TCTGCGCGGTACCAGTTTAGCCTA -> CTGCGCGGTACCAGTTTAGCCTAA
AAAGCAGGACTTATCAAACCCACC -> AAGCAGGACTTATCAAACCCACCA
TTTTCAGTGGCAGTACGGGGCTCA -> TTTCAGTGGCAGTACGGGGCTCAC
TGGACGGCGAGGGGCGGCCCTAGT -> GGACGGCGAGGGGCGGCCCTAGTA
CCTTGTGCGGTCCGAAGGCCCAGA -> CTTGTGCGGTCCGAAGGCCCAGAT
CGTTGAGATAGCACCTGATCCTCT -> GTTGAGATAGCACCTGATCCTCTT
ATACAACGCTTATAAACTTATCAC -> TACAACGCTTATAAACTTATCACC
CTGGGACCGGAACCGAGAAGAATC -> TGGGACCGGAACCGAGAAGAATCG
TAGCCGCGGAGAAGATGTCGACAC -> AGCCGCGGAGAAGATGTCGACACA
TTTCATACTGAATCCATTAGGGCG -> TTCATACTGAATCCATTAGGGCGC
GATGTCGACACATCCCTCAAGTAA -> ATGTCGACACATCCCTCAAGTAAC
TCCAGTTTCAAATAAGACGAAATC -> CCAGTTTCAAATAAGACGAAATCT
CCACATCCAAGGTCAAAGTGTGAT -> CACATCCAAGGTCAAAGTGTGATC
CAGAACTGCGTAATGCTCGTAGCA -> AGAACTGCGTAATGCTCGTAGCAA
TGACATTTTGGTTATAGGACGTAA -> GACATTTTGGTTATAGGACGTAAG
CGCTAGTTTGACCAGTCTCTCCCT -> GCTAGTTTGACCAGTCTCTCCCTG
ATACCGCACGATCAGGCATATGCT -> TACCGCACGATCAGGCATATGCTG
CAAGTAGAGCCGGAGTTCGGTAAT -> AAGTAGAGCCGGAGTTCGGTAATC
TTCACGTTTTGTTTAGACCGGTAG -> TCACGTTTTGTTTAGACCGGTAGT
GGTCGGCACGAACTTAATATGAGG -> GTCGGCACGAACTTAATATGAGGG
TACTTTCGAATACATCAATCGTCG -> ACTTTCGAATACATCAATCGTCGC
AGGACTTATCAAACCCACCAGTAT -> GGACTTATCAAACCCACCAGTATA
ATTTATGAGCACGGGTCAAATACT -> TTTATGAGCACGGGTCAAATACTT
GAGTATTCGGCTTACACACGCATG -> AGTATTCGGCTTACACACGCATGT
CCGCACGATCAGGCATATGCTGGA -> CGCACGATCAGGCATATGCTGGAA
CCGCAGAACTGCGTAATGCTCGTA -> CGCAGAACTGCGTAATGCTCGTAG
GGGGCGGCCCTAGTACTTTCCCGA -> GGGCGGCCCTAGTACTTTCCCGAA
TTGTACAAGTATCAGCGCCATCGA -> TGTACAAGTATCAGCGCCATCGAT
GTAATATTCATTTAACATGCCCAA -> TAATATTCATTTAACATGCCCAAA
AGTATACCCAAAGAATGTGCACTT -> GTATACCCAAAGAATGTGCACTTG
ACCACCCTGCAAGTAGAGCCGGAG -> CCACCCTGCAAGTAGAGCCGGAGT
CCTGACAAATGCCGTTTCGCTTGA -> CTGACAAATGCCGTTTCGCTTGAT
CCCAATTACTGGAGTAACACAAAA -> CCAATTACTGGAGTAACACAAAAC
GTGAGAGTAGTGGTCTCGGAACGT -> TGAGAGTAGTGGTCTCGGAACGTG
TACCCTGTCATACTTACCTTAAAT -> ACCCTGTCATACTTACCTTAAATC
TCGCCTCCTTTGTCTCGTCATTCC -> CGCCTCCTTTGTCTCGTCATTCCG
GGGCGCAATTTATGAGCACGGGTC -> GGCGCAATTTATGAGCACGGGTCA
ATTCATTTAACATGCCCAAAACGC -> TTCATTTAACATGCCCAAAACGCT
AACTTAAAGGCTTACGGTATACCA -> ACTTAAAGGCTTACGGTATACCAA
AACATATAACAATGAGGATACACC -> ACATATAACAATGAGGATACACCT
AGATAATCGCAACTTAAAGGCTTA -> GATAATCGCAACTTAAAGGCTTAC
AGTGGGTATGGGGGCGATTGACTT -> GTGGGTATGGGGGCGATTGACTTC
CACCCTGCAAGTAGAGCCGGAGTT -> ACCCTGCAAGTAGAGCCGGAGTTC
CGATTGACTTCCCGGCTAACTATT -> GATTGACTTCCCGGCTAACTATTT
TAGTACCTGGCACCATTGGATTTA -> AGTACCTGGCACCATTGGATTTAA
GCTTTGCTCCACATCCAAGGTCAA -> CTTTGCTCCACATCCAAGGTCAAA
TTTGTCTCGTCATTCCGAAGTACA -> TTGTCTCGTCATTCCGAAGTACAC
AGCCGGAGTTCGGTAATCTTAGTA -> GCCGGAGTTCGGTAATCTTAGTAC
AACATCTACCGATATTTGTGGAGC -> ACATCTACCGATATTTGTGGAGCA
ATCGTCGCCGCAGCGAACTCGTGC -> TCGTCGCCGCAGCGAACTCGTGCA
ACAAAACGTGACATAGCTTAAACA -> CAAAACGTGACATAGCTTAAACAG
TAGTATCCAGTTTCAAATAAGACG -> AGTATCCAGTTTCAAATAAGACGA
CCTTCGGAGTATTCGGCTTACACA -> CTTCGGAGTATTCGGCTTACACAC
CGAACTCGTGCACATTCTCACCTG -> GAACTCGTGCACATTCTCACCTGC
TGACAAATGCCGTTTCGCTTGATA -> GACAAATGCCGTTTCGCTTGATAT
CAATGCCGAGTTGTCTGGGCGTTC -> AATGCCGAGTTGTCTGGGCGTTCA
TCCGAAGGCCCAGATGTATACAAC -> CCGAAGGCCCAGATGTATACAACG
AATTACTGGAGTAACACAAAACGC -> ATTACTGGAGTAACACAAAACGCG
AATGTGCACTTGCATCTTGTCAGT -> ATGTGCACTTGCATCTTGTCAGTA
CAGAACCCGCGCTGCTAGGAGCCC -> AGAACCCGCGCTGCTAGGAGCCCG
TTTAACATGCCCAAAACGCTTATT -> TTAACATGCCCAAAACGCTTATTC
TTATGAGCACGGGTCAAATACTTT -> TATGAGCACGGGTCAAATACTTTC
GTAGTCCCAATTACTGGAGTAACA -> TAGTCCCAATTACTGGAGTAACAC
CCGAAAATAAACCTTCCGGTCGCT -> CGAAAATAAACCTTCCGGTCGCTG
ATCAGGCATATGCTGGAATCTTGA -> TCAGGCATATGCTGGAATCTTGAC
GCCTAAAGCAGGACTTATCAAACC -> CCTAAAGCAGGACTTATCAAACCC
TACGGTATGTGGGAGCAGCCCGCA -> ACGGTATGTGGGAGCAGCCCGCAG
GAAGAATCGATTTCATACTGAATC -> AAGAATCGATTTCATACTGAATCC
CGGTTGACAAAACGTGACATAGCT -> GGTTGACAAAACGTGACATAGCTT
GCGTCATGGCGACTTGCCCAAAAT -> CGTCATGGCGACTTGCCCAAAATG
TAGAGATTGGATCGCCGGTGACGC -> AGAGATTGGATCGCCGGTGACGCT
TCTAAGATAATCGCAACTTAAAGG -> CTAAGATAATCGCAACTTAAAGGC
ACAGCTCTGTATATGTGCTAAACT -> CAGCTCTGTATATGTGCTAAACTG
ACATGTTCCCTGACAAATGCCGTT -> CATGTTCCCTGACAAATGCCGTTT
GAGCCCGAAGCGGTTGACAAAACG -> AGCCCGAAGCGGTTGACAAAACGT
GACATAGCTTAAACAGATTTCGGA -> ACATAGCTTAAACAGATTTCGGAA
GCACCATTGGATTTAAGGCCTTAC -> CACCATTGGATTTAAGGCCTTACA
GAGAAGCTGCTGATGGGTGAGAGT -> AGAAGCTGCTGATGGGTGAGAGTA
CGTGGTGCCTTGTACAAGTATCAG -> GTGGTGCCTTGTACAAGTATCAGC
TCTCTATACCCTGTCATACTTACC -> CTCTATACCCTGTCATACTTACCT
ATACCCAAAGAATGTGCACTTGCA -> TACCCAAAGAATGTGCACTTGCAT
CGAACTTAATATGAGGGTCATTGT -> GAACTTAATATGAGGGTCATTGTT
TACTCTAACATCTACCGATATTTG -> ACTCTAACATCTACCGATATTTGT
CAGTAAATTTAGGGGCTGAGGTGA -> AGTAAATTTAGGGGCTGAGGTGAC
GGTATGTGGGAGCAGCCCGCAGAA -> GTATGTGGGAGCAGCCCGCAGAAC
GTTAGGTGTTTAGCCGCGGAGAAG -> TTAGGTGTTTAGCCGCGGAGAAGA
ACATTTTGTCTTGTCACAGCGTGG -> CATTTTGTCTTGTCACAGCGTGGC
TCGGTAGGCCACACGTGACATGGA -> CGGTAGGCCACACGTGACATGGAC
TCAAATAAGACGAAATCTAATGAC -> CAAATAAGACGAAATCTAATGACT
AAGACCGCACGTTGAGATAGCACC -> AGACCGCACGTTGAGATAGCACCT
ATCCATTAGGGCGCAATTTATGAG -> TCCATTAGGGCGCAATTTATGAGC
TATTTGTGGAGCAAGGTCCTCACT -> ATTTGTGGAGCAAGGTCCTCACTT
CAATATCTACGGTACAAGTCGGTA -> AATATCTACGGTACAAGTCGGTAG
ATATGTGCTAAACTGCGAGATTAC -> TATGTGCTAAACTGCGAGATTACG
CGCACGATCAGGCATATGCTGGAA -> GCACGATCAGGCATATGCTGGAAT
ATACATCAATCGTCGCCGCAGCGA -> TACATCAATCGTCGCCGCAGCGAA
ATGTGCACTTGCATCTTGTCAGTA -> TGTGCACTTGCATCTTGTCAGTAG
CCACACGTGACATGGACGGCGAGG -> CACACGTGACATGGACGGCGAGGG
TACCTGGCACCATTGGATTTAAGG -> ACCTGGCACCATTGGATTTAAGGC
GGTGTTTAGCCGCGGAGAAGATGT -> GTGTTTAGCCGCGGAGAAGATGTC
CGCAATTTATGAGCACGGGTCAAA -> GCAATTTATGAGCACGGGTCAAAT
AGGTATCTTCTTCAAACAATTCCT -> GGTATCTTCTTCAAACAATTCCTT
TGAGATAGCACCTGATCCTCTTCC -> GAGATAGCACCTGATCCTCTTCCA
GATCCCAGATCGCGCTTACTGACA -> ATCCCAGATCGCGCTTACTGACAT
AAGATAATCGCAACTTAAAGGCTT -> AGATAATCGCAACTTAAAGGCTTA
TGGATTTAAGGCCTTACAAGTCAG -> GGATTTAAGGCCTTACAAGTCAGG
TCCGAAGTACACTTAGTATCCAGT -> CCGAAGTACACTTAGTATCCAGTT
CATATAACAATGAGGATACACCTT -> ATATAACAATGAGGATACACCTTG
ATTTCATACTGAATCCATTAGGGC -> TTTCATACTGAATCCATTAGGGCG
CATCCCTCAAGTAACTGTGACAGG -> ATCCCTCAAGTAACTGTGACAGGG
GCTTACACACGCATGTAGTACCTG -> CTTACACACGCATGTAGTACCTGG
AGCAGGACTTATCAAACCCACCAG -> GCAGGACTTATCAAACCCACCAGT
CCCAGATCGCGCTTACTGACATTT -> CCAGATCGCGCTTACTGACATTTT
GGGTCATTGTTAGGTGTTTAGCCG -> GGTCATTGTTAGGTGTTTAGCCGC
TACCGATATTTGTGGAGCAAGGTC -> ACCGATATTTGTGGAGCAAGGTCC
CCGCGTAATATTCATTTAACATGC -> CGCGTAATATTCATTTAACATGCC
TATGAGTTTCCTTAATACCGCACG -> ATGAGTTTCCTTAATACCGCACGA
CGTAAGGTGCCAGTTTCCCGCGTA -> GTAAGGTGCCAGTTTCCCGCGTAA
AATCTTAGTACTCTAGGCCTTCAC -> ATCTTAGTACTCTAGGCCTTCACG
AAGATGATTCATTGTTTCGTTGCC -> AGATGATTCATTGTTTCGTTGCCC
GTTGAGATAGCACCTGATCCTCTT -> TTGAGATAGCACCTGATCCTCTTC
AGAAGAATCGATTTCATACTGAAT -> GAAGAATCGATTTCATACTGAATC
TTTCAGTGGCAGTACGGGGCTCAC -> TTCAGTGGCAGTACGGGGCTCACT
GCAGAACCCGCGCTGCTAGGAGCC -> CAGAACCCGCGCTGCTAGGAGCCC
CATACTCCAATGCCGAGTTGTCTG -> ATACTCCAATGCCGAGTTGTCTGG
TTAGGGCGCAATTTATGAGCACGG -> TAGGGCGCAATTTATGAGCACGGG
GCACGAACTTAATATGAGGGTCAT -> CACGAACTTAATATGAGGGTCATT
GTCGGCACGAACTTAATATGAGGG -> TCGGCACGAACTTAATATGAGGGT
CAGCGTGGCGTTTGAGGGTATGGT -> AGCGTGGCGTTTGAGGGTATGGTT
ACCCTGTCATACTTACCTTAAATC -> CCCTGTCATACTTACCTTAAATCT
CCTGCAAGTAGAGCCGGAGTTCGG -> CTGCAAGTAGAGCCGGAGTTCGGT
CTCTGTATATGTGCTAAACTGCGA -> TCTGTATATGTGCTAAACTGCGAG
CACCATTGGATTTAAGGCCTTACA -> ACCATTGGATTTAAGGCCTTACAA
TGCTTTAATAGTGGGTATGGGGGC -> GCTTTAATAGTGGGTATGGGGGCG
TGTCTCGTCATTCCGAAGTACACT -> GTCTCGTCATTCCGAAGTACACTT
CAAGGTCAAAGTGTGATCACTACT -> AAGGTCAAAGTGTGATCACTACTT
ACTATGTTGTGTAGACGTAGAGAT -> CTATGTTGTGTAGACGTAGAGATT
CACACGTAATCCGCAGAACCCGCG -> ACACGTAATCCGCAGAACCCGCGC
CTATACCCTGTCATACTTACCTTA -> TATACCCTGTCATACTTACCTTAA
TTGCCCCCGTCTTCGGGTAGGTAT -> TGCCCCCGTCTTCGGGTAGGTATC
ATACTGAATCCATTAGGGCGCAAT -> TACTGAATCCATTAGGGCGCAATT
GGCCACCATCATTACTCTAACATC -> GCCACCATCATTACTCTAACATCT
GTGGCAGTACGGGGCTCACTCCTC -> TGGCAGTACGGGGCTCACTCCTCC
GGCGAGGGGCGGCCCTAGTACTTT -> GCGAGGGGCGGCCCTAGTACTTTC
TGCATCTTGTCAGTAGCCATACTC -> GCATCTTGTCAGTAGCCATACTCC
TCATTCCGAAGTACACTTAGTATC -> CATTCCGAAGTACACTTAGTATCC
GGTCATTGTTAGGTGTTTAGCCGC -> GTCATTGTTAGGTGTTTAGCCGCG
TTACGGTATACCAATCAACTATGT -> TACGGTATACCAATCAACTATGTT
AGGGGCGGCCCTAGTACTTTCCCG -> GGGGCGGCCCTAGTACTTTCCCGA
TATTTTCAGTGGCAGTACGGGGCT -> ATTTTCAGTGGCAGTACGGGGCTC
AATCCATTAGGGCGCAATTTATGA -> ATCCATTAGGGCGCAATTTATGAG
TCCATAAGATGATTCATTGTTTCG -> CCATAAGATGATTCATTGTTTCGT
CAGTGGCAGTACGGGGCTCACTCC -> AGTGGCAGTACGGGGCTCACTCCT
TGGAGTAACACAAAACGCGTCATG -> GGAGTAACACAAAACGCGTCATGG
GCGGTACCAGTTTAGCCTAAAGCA -> CGGTACCAGTTTAGCCTAAAGCAG
TGGTTGCGCCACCCCCACATGTTC -> GGTTGCGCCACCCCCACATGTTCC
ATGAGGATACACCTTGTTATCGCC -> TGAGGATACACCTTGTTATCGCCT
CAATGAGGATACACCTTGTTATCG -> AATGAGGATACACCTTGTTATCGC
CTTTATGAGTTTCCTTAATACCGC -> TTTATGAGTTTCCTTAATACCGCA
ACATGCCCAAAACGCTTATTCGAC -> CATGCCCAAAACGCTTATTCGACT
CCATGCTCGTGGTGCCTTGTACAA -> CATGCTCGTGGTGCCTTGTACAAG
AGATGTCGACACATCCCTCAAGTA -> GATGTCGACACATCCCTCAAGTAA
CGGCCCTAGTACTTTCCCGAAAAT -> GGCCCTAGTACTTTCCCGAAAATA
TCTGTATATGTGCTAAACTGCGAG -> CTGTATATGTGCTAAACTGCGAGA
TGGGGGCGATTGACTTCCCGGCTA -> GGGGGCGATTGACTTCCCGGCTAA
GTTGTCTGGGCGTTCATCCCCATG -> TTGTCTGGGCGTTCATCCCCATGC
CCTAAGGCCACCATCATTACTCTA -> CTAAGGCCACCATCATTACTCTAA
TTTGTCTTGTCACAGCGTGGCGTT -> TTGTCTTGTCACAGCGTGGCGTTT
TCCTGTAGAGGGCAAATGGAACCT -> CCTGTAGAGGGCAAATGGAACCTG
GTCAAAGTGTGATCACTACTTCTT -> TCAAAGTGTGATCACTACTTCTTT
AGAATCGATTTCATACTGAATCCA -> GAATCGATTTCATACTGAATCCAT
TCTTGACATTTTGTCTTGTCACAG -> CTTGACATTTTGTCTTGTCACAGC
CACTTCGTCCTGTAGAGGGCAAAT -> ACTTCGTCCTGTAGAGGGCAAATG
CACGTGACATGGACGGCGAGGGGC -> ACGTGACATGGACGGCGAGGGGCG
GCAGTAAATTTAGGGGCTGAGGTG -> CAGTAAATTTAGGGGCTGAGGTGA
ACCCTGCAAGTAGAGCCGGAGTTC -> CCCTGCAAGTAGAGCCGGAGTTCG
CATTCTCACCTGCAGTAAATTTAG -> ATTCTCACCTGCAGTAAATTTAGG
GGCCTTACAAGTCAGGTCATTGCC -> GCCTTACAAGTCAGGTCATTGCCT
ATGTTGTGTAGACGTAGAGATTGG -> TGTTGTGTAGACGTAGAGATTGGA
GCTCTTCTGCGCGGTACCAGTTTA -> CTCTTCTGCGCGGTACCAGTTTAG
ACGCTTATAAACTTATCACCACCC -> CGCTTATAAACTTATCACCACCCT
TCTTGTCACAGCGTGGCGTTTGAG -> CTTGTCACAGCGTGGCGTTTGAGG
TAAAGCAGGACTTATCAAACCCAC -> AAAGCAGGACTTATCAAACCCACC
ATATTCATTTAACATGCCCAAAAC -> TATTCATTTAACATGCCCAAAACG
ATTGTTTCGTTGCCCCCGTCTTCG -> TTGTTTCGTTGCCCCCGTCTTCGG
CAAAACGCGTCATGGCGACTTGCC -> AAAACGCGTCATGGCGACTTGCCC
AACCCGCGCTGCTAGGAGCCCGAA -> ACCCGCGCTGCTAGGAGCCCGAAG
CACATCCAAGGTCAAAGTGTGATC -> ACATCCAAGGTCAAAGTGTGATCA
AACTGTGACAGGGTACACACGTAA -> ACTGTGACAGGGTACACACGTAAT
AGTACACTTAGTATCCAGTTTCAA -> GTACACTTAGTATCCAGTTTCAAA
TAATATGAGGGTCATTGTTAGGTG -> AATATGAGGGTCATTGTTAGGTGT
CACTCCTCCGTCTGGAAGGACACT -> ACTCCTCCGTCTGGAAGGACACTT
TGTGGGAGCAGCCCGCAGAACTGC -> GTGGGAGCAGCCCGCAGAACTGCG
TGGTTATAGGACGTAAGGTGCCAG -> GGTTATAGGACGTAAGGTGCCAGT
ACCTGGGACCCCGCTAGTTTGACC -> CCTGGGACCCCGCTAGTTTGACCA
CCCCGCTAGTTTGACCAGTCTCTC -> CCCGCTAGTTTGACCAGTCTCTCC
GTGACGCTACTTGGTGTCCCTCGA -> TGACGCTACTTGGTGTCCCTCGAA
ATTTTCAGTGGCAGTACGGGGCTC -> TTTTCAGTGGCAGTACGGGGCTCA
GTTCCCTGACAAATGCCGTTTCGC -> TTCCCTGACAAATGCCGTTTCGCT
ATTGGATCGCCGGTGACGCTACTT -> TTGGATCGCCGGTGACGCTACTTG
ACTTCGTCCTGTAGAGGGCAAATG -> CTTCGTCCTGTAGAGGGCAAATGG
TCGGCTTACACACGCATGTAGTAC -> CGGCTTACACACGCATGTAGTACC
CCGTTTCGCTTGATATCAGCTGGT -> CGTTTCGCTTGATATCAGCTGGTC
ATACCAATCAACTATGTTGTGTAG -> TACCAATCAACTATGTTGTGTAGA
CGTTGCCCCCGTCTTCGGGTAGGT -> GTTGCCCCCGTCTTCGGGTAGGTA
TCATTGTTTCGTTGCCCCCGTCTT -> CATTGTTTCGTTGCCCCCGTCTTC
GAAGTACACTTAGTATCCAGTTTC -> AAGTACACTTAGTATCCAGTTTCA
GAGCAGCCCGCAGAACTGCGTAAT -> AGCAGCCCGCAGAACTGCGTAATG
GGTACAAGTCGGTAGGCCACACGT -> GTACAAGTCGGTAGGCCACACGTG
TGAGCACGGGTCAAATACTTTCGA -> GAGCACGGGTCAAATACTTTCGAA
GTCAAATACTTTCGAATACATCAA -> TCAAATACTTTCGAATACATCAAT
TATGGTTGCGCCACCCCCACATGT -> ATGGTTGCGCCACCCCCACATGTT
CGGTAGGCCACACGTGACATGGAC -> GGTAGGCCACACGTGACATGGACG
TTTGTTTAGACCGGTAGTCCCAAT -> TTGTTTAGACCGGTAGTCCCAATT
ACCAGTTTAGCCTAAAGCAGGACT -> CCAGTTTAGCCTAAAGCAGGACTT
CTTCACGTTTTGTTTAGACCGGTA -> TTCACGTTTTGTTTAGACCGGTAG
TCTGGAAGGACACTTTTGAACAAC -> CTGGAAGGACACTTTTGAACAACC
TTACGAATGAGACATATTCCCGGT -> TACGAATGAGACATATTCCCGGTG
GCCGCAGCGAACTCGTGCACATTC -> CCGCAGCGAACTCGTGCACATTCT
CCGCGGAGAAGATGTCGACACATC -> CGCGGAGAAGATGTCGACACATCC
TGAGTTTCCTTAATACCGCACGAT -> GAGTTTCCTTAATACCGCACGATC
CGAGAAGAATCGATTTCATACTGA -> GAGAAGAATCGATTTCATACTGAA
TACAAGTATCAGCGCCATCGATGC -> ACAAGTATCAGCGCCATCGATGCT
CCTCCGTCTGGAAGGACACTTTTG -> CTCCGTCTGGAAGGACACTTTTGA
CAATTACTGGAGTAACACAAAACG -> AATTACTGGAGTAACACAAAACGC
CTTCGGGTAGGTATCTTCTTCAAA -> TTCGGGTAGGTATCTTCTTCAAAC
ACCTAAGGCCACCATCATTACTCT -> CCTAAGGCCACCATCATTACTCTA
GCGCAATTTATGAGCACGGGTCAA -> CGCAATTTATGAGCACGGGTCAAA
CCAAAGAATGTGCACTTGCATCTT -> CAAAGAATGTGCACTTGCATCTTG
CTGAGGTGACTGGATGGTCGGCAC -> TGAGGTGACTGGATGGTCGGCACG
TTGTCAGTAGCCATACTCCAATGC -> TGTCAGTAGCCATACTCCAATGCC
GCTACTTGGTGTCCCTCGAATTTA -> CTACTTGGTGTCCCTCGAATTTAC
ACAGGGTACACACGTAATCCGCAG -> CAGGGTACACACGTAATCCGCAGA
TCATCCCCATGCTCGTGGTGCCTT -> CATCCCCATGCTCGTGGTGCCTTG
CCAATGCCGAGTTGTCTGGGCGTT -> CAATGCCGAGTTGTCTGGGCGTTC
CGGTGTCTAAGATAATCGCAACTT -> GGTGTCTAAGATAATCGCAACTTA
CAGCGAACTCGTGCACATTCTCAC -> AGCGAACTCGTGCACATTCTCACC
ATGTCGACACATCCCTCAAGTAAC -> TGTCGACACATCCCTCAAGTAACT
AAGTCAGGTCATTGCCTGCTTTAG -> AGTCAGGTCATTGCCTGCTTTAGG
GTCTTGTCACAGCGTGGCGTTTGA -> TCTTGTCACAGCGTGGCGTTTGAG
GTGTAGACGTAGAGATTGGATCGC -> TGTAGACGTAGAGATTGGATCGCC
CGAATTTACAGCTCTGTATATGTG -> GAATTTACAGCTCTGTATATGTGC
TGCTCCACATCCAAGGTCAAAGTG -> GCTCCACATCCAAGGTCAAAGTGT
CTTTAATAGTGGGTATGGGGGCGA -> TTTAATAGTGGGTATGGGGGCGAT
TGTAGAGGGCAAATGGAACCTGGG -> GTAGAGGGCAAATGGAACCTGGGA
TCGTCGCCGCAGCGAACTCGTGCA -> CGTCGCCGCAGCGAACTCGTGCAC
TCGATTTCATACTGAATCCATTAG -> CGATTTCATACTGAATCCATTAGG
TTAGGTGTTTAGCCGCGGAGAAGA -> TAGGTGTTTAGCCGCGGAGAAGAT
TGGGCGTTCATCCCCATGCTCGTG -> GGGCGTTCATCCCCATGCTCGTGG
CTGCGCTTTGCTCCACATCCAAGG -> TGCGCTTTGCTCCACATCCAAGGT
CAGCTGGTCCACGATCCCAGATCG -> AGCTGGTCCACGATCCCAGATCGC
CCCGCTAGTTTGACCAGTCTCTCC -> CCGCTAGTTTGACCAGTCTCTCCC
TTCGGAGTATTCGGCTTACACACG -> TCGGAGTATTCGGCTTACACACGC
TTAGTATCCAGTTTCAAATAAGAC -> TAGTATCCAGTTTCAAATAAGACG
ATTACTGGAGTAACACAAAACGCG -> TTACTGGAGTAACACAAAACGCGT
GTCTTCGGGTAGGTATCTTCTTCA -> TCTTCGGGTAGGTATCTTCTTCAA
ACATTTTGGTTATAGGACGTAAGG -> CATTTTGGTTATAGGACGTAAGGT
ACCTTCCGGTCGCTGCGCTTTGCT -> CCTTCCGGTCGCTGCGCTTTGCTC
CCTGGCACCATTGGATTTAAGGCC -> CTGGCACCATTGGATTTAAGGCCT
AGTTTCAAATAAGACGAAATCTAA -> GTTTCAAATAAGACGAAATCTAAT
CTGGGACCCCGCTAGTTTGACCAG -> TGGGACCCCGCTAGTTTGACCAGT
GTATGTGGGAGCAGCCCGCAGAAC -> TATGTGGGAGCAGCCCGCAGAACT
TTGAGATAGCACCTGATCCTCTTC -> TGAGATAGCACCTGATCCTCTTCC
ATACACCTTGTTATCGCCTCCTTT -> TACACCTTGTTATCGCCTCCTTTG
GCCGGTGACGCTACTTGGTGTCCC -> CCGGTGACGCTACTTGGTGTCCCT
CGCCACCCCCACATGTTCCCTGAC -> GCCACCCCCACATGTTCCCTGACA
ACGCATGTAGTACCTGGCACCATT -> CGCATGTAGTACCTGGCACCATTG
AATGCCGAGTTGTCTGGGCGTTCA -> ATGCCGAGTTGTCTGGGCGTTCAT
AGTACCTGGCACCATTGGATTTAA -> GTACCTGGCACCATTGGATTTAAG
TCCGCAGAACCCGCGCTGCTAGGA -> CCGCAGAACCCGCGCTGCTAGGAG
GCACCTGATCCTCTTCCATAAGAT -> CACCTGATCCTCTTCCATAAGATG
TATGGGGGCGATTGACTTCCCGGC -> ATGGGGGCGATTGACTTCCCGGCT
TCACCACCCTGCAAGTAGAGCCGG -> CACCACCCTGCAAGTAGAGCCGGA
CGTTTCGCTTGATATCAGCTGGTC -> GTTTCGCTTGATATCAGCTGGTCC
CGAGAAGCTGCTGATGGGTGAGAG -> GAGAAGCTGCTGATGGGTGAGAGT
AGTTCGGTAATCTTAGTACTCTAG -> GTTCGGTAATCTTAGTACTCTAGG
TGTCCCTCGAATTTACAGCTCTGT -> GTCCCTCGAATTTACAGCTCTGTA
TTTAGCCTAAAGCAGGACTTATCA -> TTAGCCTAAAGCAGGACTTATCAA
GCTAACTATTTTCAGTGGCAGTAC -> CTAACTATTTTCAGTGGCAGTACG
TTCCCGGTGTCTAAGATAATCGCA -> TCCCGGTGTCTAAGATAATCGCAA
CCCATGCTCGTGGTGCCTTGTACA -> CCATGCTCGTGGTGCCTTGTACAA
GCTCGTGGTGCCTTGTACAAGTAT -> CTCGTGGTGCCTTGTACAAGTATC
GACCCCGCTAGTTTGACCAGTCTC -> ACCCCGCTAGTTTGACCAGTCTCT
CAAGTATCAGCGCCATCGATGCTT -> AAGTATCAGCGCCATCGATGCTTT
GAACCTGGGACCCCGCTAGTTTGA -> AACCTGGGACCCCGCTAGTTTGAC
AGAACTGCGTAATGCTCGTAGCAA -> GAACTGCGTAATGCTCGTAGCAAT
ATCTACCGATATTTGTGGAGCAAG -> TCTACCGATATTTGTGGAGCAAGG
AATAAGACGAAATCTAATGACTGT -> ATAAGACGAAATCTAATGACTGTT
GCCGAGTTGTCTGGGCGTTCATCC -> CCGAGTTGTCTGGGCGTTCATCCC
GCTAGTTTGACCAGTCTCTCCCTG -> CTAGTTTGACCAGTCTCTCCCTGG
AGTCGGTAGGCCACACGTGACATG -> GTCGGTAGGCCACACGTGACATGG
GGTACCAGTTTAGCCTAAAGCAGG -> GTACCAGTTTAGCCTAAAGCAGGA
TAAATTTAGGGGCTGAGGTGACTG -> AAATTTAGGGGCTGAGGTGACTGG
CTCACCTAAGGCCACCATCATTAC -> TCACCTAAGGCCACCATCATTACT
ATTGACTTCCCGGCTAACTATTTT -> TTGACTTCCCGGCTAACTATTTTC
CATTGGATTTAAGGCCTTACAAGT -> ATTGGATTTAAGGCCTTACAAGTC
CACACGCATGTAGTACCTGGCACC -> ACACGCATGTAGTACCTGGCACCA
TTCATCCCCATGCTCGTGGTGCCT -> TCATCCCCATGCTCGTGGTGCCTT
TTGACTTCCCGGCTAACTATTTTC -> TGACTTCCCGGCTAACTATTTTCA
TGGCACCATTGGATTTAAGGCCTT -> GGCACCATTGGATTTAAGGCCTTA
GGCTAACTATTTTCAGTGGCAGTA -> GCTAACTATTTTCAGTGGCAGTAC
CAAGTCAGGTCATTGCCTGCTTTA -> AAGTCAGGTCATTGCCTGCTTTAG
TGCCAGTTTCCCGCGTAATATTCA -> GCCAGTTTCCCGCGTAATATTCAT
ATATAACAATGAGGATACACCTTG -> TATAACAATGAGGATACACCTTGT
TACAAGTCGGTAGGCCACACGTGA -> ACAAGTCGGTAGGCCACACGTGAC
GTGAAGACCGCACGTTGAGATAGC -> TGAAGACCGCACGTTGAGATAGCA
AGTAGAGCCGGAGTTCGGTAATCT -> GTAGAGCCGGAGTTCGGTAATCTT
ATAAACCTTCCGGTCGCTGCGCTT -> TAAACCTTCCGGTCGCTGCGCTTT
AATCGCAACTTAAAGGCTTACGGT -> ATCGCAACTTAAAGGCTTACGGTA
CTCCGTCTGGAAGGACACTTTTGA -> TCCGTCTGGAAGGACACTTTTGAA
CACATGTTCCCTGACAAATGCCGT -> ACATGTTCCCTGACAAATGCCGTT
TCATGGCGACTTGCCCAAAATGTC -> CATGGCGACTTGCCCAAAATGTCC
CTGGTCCACGATCCCAGATCGCGC -> TGGTCCACGATCCCAGATCGCGCT
TAGAAAACGCCCACTCCATCTCTA -> AGAAAACGCCCACTCCATCTCTAT
ACATATTCCCGGTGTCTAAGATAA -> CATATTCCCGGTGTCTAAGATAAT
TCAGCGCCATCGATGCTTTAATAG -> CAGCGCCATCGATGCTTTAATAGT
ACTCTAGGCCTTCACGTTTTGTTT -> CTCTAGGCCTTCACGTTTTGTTTA
GCAAATGGAACCTGGGACCCCGCT -> CAAATGGAACCTGGGACCCCGCTA
ATACCCTGTCATACTTACCTTAAA -> TACCCTGTCATACTTACCTTAAAT
AAGGTCAAAGTGTGATCACTACTT -> AGGTCAAAGTGTGATCACTACTTC
TCAAACAATTCCTTCGGAGTATTC -> CAAACAATTCCTTCGGAGTATTCG
GTCCTGGGACCGGAACCGAGAAGA -> TCCTGGGACCGGAACCGAGAAGAA
CTTCCGGTCGCTGCGCTTTGCTCC -> TTCCGGTCGCTGCGCTTTGCTCCA
CGATTTCATACTGAATCCATTAGG -> GATTTCATACTGAATCCATTAGGG
TTACTGGAGTAACACAAAACGCGT -> TACTGGAGTAACACAAAACGCGTC
CCCCATGCTCGTGGTGCCTTGTAC -> CCCATGCTCGTGGTGCCTTGTACA
TCTGAAGGCTCTTCTGCGCGGTAC -> CTGAAGGCTCTTCTGCGCGGTACC
GTATCAGCGCCATCGATGCTTTAA -> TATCAGCGCCATCGATGCTTTAAT
TGATGGGTGAGAGTAGTGGTCTCG -> GATGGGTGAGAGTAGTGGTCTCGG
CGACACATCCCTCAAGTAACTGTG -> GACACATCCCTCAAGTAACTGTGA
ATAGCACCTGATCCTCTTCCATAA -> TAGCACCTGATCCTCTTCCATAAG
GAGTTTCCTTAATACCGCACGATC -> AGTTTCCTTAATACCGCACGATCA
CCTTACAAGTCAGGTCATTGCCTG -> CTTACAAGTCAGGTCATTGCCTGC
AGGTCATTGCCTGCTTTAGGAAAT -> GGTCATTGCCTGCTTTAGGAAATC
CTAACTATTTTCAGTGGCAGTACG -> TAACTATTTTCAGTGGCAGTACGG
GACAAAACGTGACATAGCTTAAAC -> ACAAAACGTGACATAGCTTAAACA
CGGTATGTGGGAGCAGCCCGCAGA -> GGTATGTGGGAGCAGCCCGCAGAA
CATTTTGGTTATAGGACGTAAGGT -> ATTTTGGTTATAGGACGTAAGGTG
GCGTTTGAGGGTATGGTTGCGCCA -> CGTTTGAGGGTATGGTTGCGCCAC
TCATTTAACATGCCCAAAACGCTT -> CATTTAACATGCCCAAAACGCTTA